字段汇总文件
==================================================

【1】基本资料
------------------------------
证券简称 -> sec_name
同公司B股简称 -> bsharename
证券英文简称 -> sec_englishname
上市日期 -> ipo_date
交易所中文名称 -> exchange_cn
交易所英文简称 -> exch_eng
上市板 -> mkt
证券存续状态 -> sec_status
戴帽摘帽时间 -> riskadmonition_date
摘牌日期 -> delist_date
发行币种 -> issuecurrencycode
交易币种 -> curr
交易结算模式 -> fund_settlementmode
每股面值 -> parvalue
每手股数 -> lotsize
交易单位 -> tunit
上市地所属国家或地区代码 -> country
发布机构 -> crm_issuer
基期 -> basedate
基点 -> basevalue
成份个数 -> numberofconstituents
成份个数（支持历史） -> numberofconstituents2
最早成份日期 -> firstdayofconstituents
加权方式 -> methodology
证券简介 -> repo_briefing
发布日期 -> launchdate
证券曾用名 -> prename
证券简称（支持历史） -> sec_name1
上市地点 -> exch_city
跟踪标的基金代码 -> trackedbyfunds
上级行业指数代码 -> superiorcode
Wind代码 -> windcode
证券代码 -> trade_code
股票种类 -> stockclass
发行制度 -> ipo_issuingsystem
所属上市标准 -> liststd
北交所准入标准 -> featuredliststd
是否属于重要指数成份 -> compindex2
所属概念板块 -> concept
所属热门概念 -> hotconcept
所属最新概念 -> latestconcept
所属规模风格类型 -> scalestyle
是否融资融券标的 -> marginornot
是否沪港通买入标的 -> SHSC
是否深港通买入标的 -> SHSC2
纳入港股通日期 -> hksc_date
是否并行代码 -> parallelcode
证券类型 -> sec_type
证券类型（细类） -> sec_type_de
是否借壳上市 -> backdoor
借壳上市日期 -> backdoordate
是否上市（挂牌） -> list
是否属于风险警示板 -> riskwarning
指数分类(Wind) -> windtype
指数风格 -> officialstyle
所属产业链板块 -> chain
所属大宗商品概念板块 -> largecommodity
是否属于指数成份 -> compindex3
每份DR代表股份数 -> RO
已发行DR数量 -> share_dr
基础证券Wind代码 -> underlyingwindcode2
存托机构 -> depositarybank
公司中文名称 -> comp_name
公司英文名称 -> comp_name_eng
企业所有制性质 -> nature1
金融机构类型 -> institutiontype
企业规模 -> corpscale
上市公司（银行）类型 -> banktype
成立日期 -> founddate1
注册资本 -> regcapital
注册资本币种 -> regcapitalcur
法定代表人 -> chairman
法定代表人（支持历史） -> legalrepresentative
会计年结日 -> fiscaldate
经营范围 -> business
公司简介 -> briefing
主营产品类型 -> majorproducttype
主营产品名称 -> majorproductname
员工总数 -> employee
母公司员工人数 -> employee_pc
所属行政区划 -> administrativedivision
所属行政区划代码 -> admincode
所属证监会辖区 -> csrcjurisdiction
省份 -> province
城市 -> city
注册地址 -> address
注册地所在国家或地区 -> area
办公地址 -> office
邮编 -> zipcode
公司电话 -> phone
公司传真 -> fax
公司电子邮件地址 -> email
公司网站 -> website
信息披露人 -> discloser
信息指定披露媒体 -> media
统一社会信用代码 -> registernumber
公司发行债券一览 -> relatedbond
组织机构代码 -> organizationcode
记账本位币 -> report_cur
是否上市公司 -> listingornot1
是否上市公司 -> listingornot
单一债务主体中文简称 -> issuershortened
主要产品及业务 -> mainproduct
公司曾用名 -> compprename
是否发行可转债 -> cbissueornot
是否IPO时尚未盈利 -> earning
是否存在投票权差异 -> vote
是否专精特新企业 -> zjtxornot
是否企业本身为专精特新 -> zjtxitselfornot
是否高新技术企业 -> gxjsornot
是否企业的参控股公司为专精特新企业 -> ckgzjtxornot
是否VIE结构 -> vieornot
是否SPAC上市 -> spacornot
所属Wind行业名称(2024) -> wicsname2024
所属Wind行业代码(2024) -> wicscode2024
所属Wind行业指数代码 -> indexcode_wind
所属Wind行业指数代码（港股） -> indexcode_wind_hk
所属Wind主题行业名称 -> thematicindustry_wind
所属Wind主题行业指数代码 -> indexcode_windthematic
所属中上协行业名称 -> industry_csrc2023
所属中上协行业代码 -> industry_csrccode2023
所属申万行业名称(2014) -> industry_sw
所属申万行业代码(2014) -> industry_swcode
所属申万行业原始代码(2014) -> industry_sworigincode
所属申万行业指数代码 -> indexcode_sw
所属申万行业名称(2021) -> industry_sw_2021
所属申万行业代码(2021) -> industry_swcode_2021
所属申万行业原始代码(2021) -> industry_sworigincode_2021
所属申万行业名称（港股）(2014) -> industry_sw_hk
所属申万行业代码（港股）(2014) -> industry_swcode_hk
所属申万行业名称（港股）(2021) -> industry_sw_2021_hk
所属申万行业代码（港股）(2021) -> industry_swcode_2021_hk
所属中信行业名称 -> industry_citic
所属中信行业代码 -> industry_citiccode
所属中信行业原始代码 -> industry_citicorigincode
所属中信行业指数代码 -> indexcode_citic
所属中信风格指数代码 -> styleindexcode_citic
所属中信风格指数名称 -> styleindexname_citic
所属中信证券港股通指数代码（港股） -> indexcode_citic_hk
所属中信证券港股通指数名称（港股） -> indexname_citic_hk
所属中信行业名称（港股） -> industry_citic_hk
所属中信行业代码（港股） -> industry_citiccode_hk
所属恒生行业名称 -> industry_HS
所属恒生综合行业指数名称 -> indexname_hs
所属行业名称（支持历史） -> industry2
所属行业代码（支持历史） -> industrycode
所属行业板块名称（支持历史） -> industryname
所属AMAC行业指数名称 -> indexname_AMAC
所属AMAC行业指数代码 -> indexcode_AMAC
所属中证行业名称 -> industry_csi
所属中证行业代码 -> industry_csicode
所属国民经济行业分类 -> industry_nc
所属国民经济行业代码 -> industry_nccode
所属长江行业名称 -> industry_cjsc
所属长江行业指数代码 -> indexcode_cjsc
所属国证行业名称 -> industry_cn
所属国证行业代码 -> industry_cncode
所属国证行业指数代码 -> imuexcoue_cn
所属战略新兴产业 -> thematicindustry_sib
所属Wind行业名称(2004) -> industry_gics
所属Wind行业代码(2004) -> industry_gicscode
所属证监会行业名称（旧） -> industry_CSRC
所属证监会行业代码（旧） -> industry_CSRCcode
(停止)所属证监会行业名称 -> industry_csrc12_n
(停止)所属证监会行业代码 -> industry_CSRCcode12
董事长 -> boardchairmen
总经理 -> ceo
董事会秘书 -> discloser1
证券事务代表 -> sar1
财务总监 -> cfo
公司独立董事（现任） -> crtindpdirector
公司独立董事（历任） -> sucindpdirector
公司董事 -> director
公司董事（历任） -> sucdirector
公司监事 -> supervisor
公司监事（历任） -> sucsupervisor
公司高管 -> executives
公司高管（历任） -> sucexecutives
管理层年度薪酬总额 -> wgsd_stmnote_mgmt_ben
金额前三的董事薪酬合计 -> wgsd_stmnote_mgmt_ben_top3b
金额前三的高管薪酬合计 -> wgsd_stmnote_mgmt_ben_top3m
董事长薪酬 -> wgsd_stmnote_mgmt_ben_bc
独立董事薪酬 -> wgsd_stmnote_mgmt_ben_id
总经理薪酬 -> wgsd_stmnote_mgmt_ben_ceo
财务总监薪酬 -> wgsd_stmnote_mgmt_ben_cfo
董事会秘书薪酬 -> wgsd_stmnote_mgmt_ben_discloser
证券事务代表薪酬 -> stmnote_mgmt_ben_sar
董事会人数 -> employee_board
非独立董事人数 -> employee_executivedirector
独立董事人数 -> employee_indpdirector
高管人数 -> employee_mgmt
核心技术人员人数 -> employee_techcore
审计机构 -> auditor
法律顾问 -> clo
经办律师 -> lic
资产评估机构 -> assetapp
经办评估人员 -> vic
主要往来银行 -> banks
主办券商（持续督导） -> ipo_leadundr_n1
生产人员人数 -> employee_producer
销售人员人数 -> employee_sale
客服人员人数 -> employee_server
技术人员人数 -> employee_tech
财务人员人数 -> employee_fin
人事人员人数 -> employee_hr
行政人员人数 -> employee_excu
综合管理人员人数 -> employee_admin
风控稽核人员人数 -> employee_rc
采购仓储人员人数 -> employee_pur
其他人员人数 -> employee_othdept
博士人数 -> employee_PHD
硕士人数 -> employee_MS
本科人数 -> employee_BA
专科人数 -> employee_coll
高中及以下人数 -> employee_highschool
其他学历人数 -> employee_othdegree
生产人员人数占比 -> employee_producer_pct
销售人员人数占比 -> employee_sale_pct
客服人员人数占比 -> employee_server_pct
技术人员人数占比 -> employee_tech_pct
财务人员人数占比 -> employee_fin_pct
人事人员人数占比 -> employee_hr_pct
行政人员人数占比 -> employee_excu_pct
综合管理人员人数占比 -> employee_admin_pct
风控稽核人员人数占比 -> employee_rc_pct
采购仓储人员人数占比 -> employee_pur_pct
其他专业人员人数占比 -> employee_othdept_pct
博士人数占比 -> employee_PHD_pct
硕士人数占比 -> employee_MS_pct
本科人数占比 -> employee_BA_pct
专科人数占比 -> employee_coll_pct
高中及以下人数占比 -> employee_highschool_pct
其他学历人数占比 -> employee_othdegree_pct
总股本 -> total_shares
自由流通股本 -> free_float_shares
流通A股 -> float_a_shares
限售A股 -> share_restricteda
A股合计 -> share_totala
流通B股 -> share_liqb
限售B股 -> share_restrictedb
B股合计 -> share_totalb
三板合计 -> share_totalotc
香港上市股 -> share_h
海外上市股 -> share_oversea
流通股合计 -> share_totaltradable
限售股合计 -> share_totalrestricted
非流通股 -> share_nontradable2
优先股 -> share_ntrd_prfshare
证券发行数量 -> share_issuing
上市前总股本 -> share_totshares_pre
流通股本（含限售股） -> share_issuing_mkt
流通A股占总股本比例 -> share_liqa_pct
限售A股占总股本比例 -> share_restricteda_pct
A股合计占总股本比例 -> share_totala_pct
流通B股占总股本比例 -> share_liqb_pct
限售B股占总股本比例 -> share_restrictedb_pct
B股合计占总股本比例 -> share_totalb_pct
三板A股占总股本比例 -> share_otca_pct
三板B股占总股本比例 -> share_otcb_pct
三板合计占总股本比例 -> share_totalotc_pct
香港上市股占总股本比例 -> share_liqh_pct
海外上市股占总股本比例 -> share_oversea_pct
流通股合计占总股本比例 -> share_tradable_pct
限售股合计占总股本比例 -> share_restricted_pct
股改前非流通股占总股本比例 -> share_nontradable_pct
自由流通股占总股本比例 -> share_freefloatshr_pct
限售股份（国家持股） -> share_rtd_state
限售股份（国有法人持股） -> share_rtd_statejur
限售股份（其他内资持股合计） -> share_rtd__subotherdomes
限售股份（境内法人持股） -> share_rtd_domesjur
限售股份（机构配售股份） -> share_rtd_inst
限售股份（境内自然人持股） -> share_rtd_domesnp
限售股份（外资持股合计） -> share_rtd_subfrgn
限售股份（境外法人持股） -> share_rtd_frgnjur
限售股份（境外自然人持股） -> share_rtd_frgnnp
质押股份数量合计 -> share_pledgeda
质押比例 -> share_pledgeda_pct
无限售股份质押数量 -> share_liqa_pledged
无限售股份质押比例 -> share_liqa_pledgedpct
有限售股份质押数量 -> share_restricteda_pledged
有限售股份质押比例 -> share_restricteda_pledgedpct
质押待购回余量 -> share_pledged_repurchase
限售解禁日期 -> share_rtd_unlockingdate
本期解禁数量 -> share_tradable_current
未流通数量 -> share_rtd_bance
解禁数据类型 -> share_rtd_datatype
解禁股份性质 -> share_tradable_sharetype
指定日之后最近一次解禁日期 -> share_rtd_unlockingdate_fwd
指定日之后最近一次解禁数量 -> share_tradable_current_fwd
指定日之后最近一次解禁数据类型 -> share_rtd_datatype_fwd
指定日之后最近一次解禁股份性质 -> share_tradable_sharetype_fwd
基金份额 -> unit_total
基金份额（合计） -> unit_fundshare_total
份额是否为合并数据 -> unit_mergedsharesornot
场内流通份额 -> unit_floortrading
REITs场内流通份额 -> unit_reitsfloortrading
REITs未流通份额 -> unit_reitsfloornontrading
当期场内流通份额变化 -> unit_floortradingchange
报告期总申购份额 -> unit_purchase
报告期总赎回份额 -> unit_redemption
报告期申购赎回净额 -> unit_netpurchase
单季度总申购份额 -> unit_purchase_qty
单季度总赎回份额 -> unit_redemption_qty
单季度净申购赎回率 -> unit_netquarterlyratio
单季度申购赎回净额 -> unit_netpurchase_qty

【2】基本资料
------------------------------
前十大流通股东持股数量合计 -> holder_top10liqquantity
前十大流通股东持股比例合计 -> holder_tlttop10liqpct
大股东累计质押数量 -> share_pledgeda_holder
大股东累计质押数占持股数比例 -> share_pledgeda_pct_holder
大股东累计冻结数量 -> share_frozena_holder
大股东累计冻结数占持股数比例 -> share_frozena_pct_holder
公布实际控制人名称 -> holder_rptController
公布控股股东名称 -> shareholder_rptControlling
实际控制人属性 -> holder_controllerattr
大股东名称 -> holder_name
大股东持股数量 -> holder_quantity
大股东持股比例 -> holder_pct
大股东持股股本性质 -> holder_sharecategory
大股东持有的限售股份数 -> holder_quantity_restricted
大股东性质 -> holder_nature
流通股东名称 -> holder_liqname
流通股东持股数量 -> holder_liqquantity
流通股东持股比例 -> holder_liqpct
流通股东持股比例（相对总股本） -> holder_pct_liq
流通股东持股股本性质 -> holder_liqsharecategory
股东公司简介 -> shareholderbriefing
股东公司属性 -> shareholdernature
大股东累计质押数量（旧） -> share_pledgeda_largestholder
大股东累计质押数占持股数比例（旧） -> share_pledgeda_pct_largestholder
股东户数 -> holder_num2
户均持股数量 -> holder_avgnum
户均持股比例 -> holder_avgpct
户均持股比例半年增长率 -> holder_havgpctchange
户均持股比例季度增长率 -> holder_qavgpctchange
户均持股数半年增长率 -> holder_havgchange
户均持股数季度增长率 -> holder_qavgchange
相对上一报告期户均持股比例差 -> holder_avgpctchange
机构股东名称 -> holder_institute
机构股东类型 -> holder_category
机构持股数量合计 -> holder_totalbyinst
基金持股数量 -> holder_totalbyfund
券商持股数量 -> holder_totalbybysec
理财产品持股数量 -> holder_totalbybywmp
阳光私募持股数量 -> holder_totalbyhf
QFII持股数量 -> holder_totalbyqfii
保险公司持股数量 -> holder_totalbyinsur
社保基金持股数量 -> holder_totalbyssfund
企业年金持股数量 -> holder_totalbycorppension
信托公司持股数量 -> holder_totalbytrustcorp
财务公司持股数量 -> holder_totalbyfinancecorp
银行持股数量 -> holder_totalbybank
一般法人持股数量 -> holder_totalbygeneralcorp
非金融类上市公司持股数量 -> holder_totalbylnfcorp
机构持股比例合计 -> holder_pctbyinst
基金持股比例 -> holder_pctbyfund
券商持股比例 -> holder_pctbysec
理财产品持股比例 -> holder_pctbybywmp
阳光私募持股比例 -> holder_pctbyhf
QFII持股比例 -> holder_pctbyqfi
保险公司持股比例 -> holder_pctbyinsur
社保基金持股比例 -> holder_pctbyssfund
企业年金持股比例 -> holder_pctbycorppension
信托公司持股比例 -> holder_pctbytrustcorp
财务公司持股比例 -> holder_pctbyfinancecorp
银行持股比例 -> holder_pctbybank
一般法人持股比例 -> holder_pctbygeneralcorp
非金融类上市公司持股比例 -> holder_pctbylnfcorp
持股机构数 -> holder_num_i
持股基金数 -> holder_num_fund
持股社保基金数 -> holder_num_ssfund
持股QFII数 -> holder_num_qfi
持股保险公司数 -> holder_num_insur
定向增发价格 -> holder_price_fellowon
管理层增持价格 -> holder_price_mh
大股东增持价格 -> holder_price_Majorshareholders
员工持股计划买入价格 -> holder_price_ESOP
股权激励行权价格 -> holder_price_stockbasedcompensation
基金份额持有人户数 -> holder_number
持有人户数是否为合并数据 -> holder_mergednumberornot
基金份额持有人户数（合计） -> fund_holder_totalnumber
平均每户持有基金份额 -> holder_avgholding
机构投资者持有份额 -> holder_institution_holding
机构投资者持有比例 -> holder_institution_holdingpct
机构投资者持有份额（合计） -> holder_institution_totalholding
机构投资者持有比例（合计） -> holder_institution_totalholdingpct
管理人员工持有份额 -> holder_mngemp_holding
管理人员工持有比例 -> holder_mngemp_holdingpct
管理人员工持有份额（合计） -> holder_mngemp_totalholding
管理人员工持有比例（合计） -> holder_mngemp_totalholdingpct
基金管理公司持有份额 -> holder_corp_holding
基金管理公司持有比例 -> holder_corp_holdingpct
个人投资者持有份额 -> holder_personal_holding
个人投资者持有份额（合计） -> holder_personal_totalholding
个人投资者持有比例 -> holder_personal_holdingpct
个人投资者持有比例（合计） -> holder_personal_totalholdingpct
持有份额是否为合并数据 -> holder_mergedholdingornot
第N名持有人名称 -> fund_holder_name
第N名持有人持有份额 -> fund_holder_holding
第N名持有人持有比例 -> fund_holder_pct
第N名持有人名称（上市公告） -> fund_holder_namelisting
第N名持有人持有份额（上市公告） -> fund_holder_holdinglisting
第N名持有人持有比例（上市公告） -> fund_holder_pctlisting
前十大持有人持有份额合计 -> fund_holder_top10_holding
前十大持有人持有比例合计 -> fund_holder_top10_pct
第N名持有人类别（货币） -> fund_holder_namemmf
第N名持有人持有份额（货币） -> fund_holder_holdingmmf
第N名持有人持有比例（货币） -> fund_holder_pctmmf
前十大持有人持有比例合计（货币） -> fund_holder_top10_pctmmf
前十大持有人持有份额合计（货币） -> fund_holder_top10_holdingmmf
合格投资者类型 -> bond_qualified_investor
持有基金家数 -> fundhold_funds
持有券商资管家数 -> assetmanagementshold_products
基金持有数量合计占存量比 -> fundhold_ratioofpositiontoamnt
基金持有数量合计 -> fundhold_position
持有人名称 -> bondholder_name
持有人持有比例 -> bondholder_pct
持有人持有数量 -> bondholder_quantity
持有基金名称 -> fundholdbond_names
基金持债市值 -> fundholdbond_value
基金持债市值占发行量比 -> fundholdbond_ratio
沪（深）股通持股数量 -> share_N
港股通持股数量 -> share_HKS
沪市港股通持股数量 -> share_HKSH
深市港股通持股数量 -> share_HKSZ
香港本地中介机构持股数量 -> share_HK
中资中介机构持股数量 -> share_CN
国际中介机构持股数量 -> share_OS
沪（深）股通持股占比 -> share_pct_N
沪（深）股通持股占自由流通股比例 -> share_pct_Ntofreefloat
沪（深）股通持股占流通A股比例 -> share_pct_SHNLIQA
港股通持股占比 -> share_pct_HKS
沪市港股通持股占比 -> share_pct_HKSH
深市港股通持股占比 -> share_pct_HKSZ
香港本地中介机构持股占比 -> share_pct_HK
中资中介机构持股占比 -> share_pct_CN
国际中介机构持股占比 -> share_pct_OS
港股通持股/香港股 -> share_cpct_hks
沪市港股通持股/香港股 -> share_cpct_hksh
深市港股通持股/香港股 -> share_cpct_hksz
香港本地中介机构持股/香港股 -> share_cpct_hk
中资中介机构持股/香港股 -> share_cpct_cn
国际中介机构持股/香港股 -> share_cpct_os
证券全称 -> fullname
债务主体 -> issuerupdated
穿透信用主体中文名称 -> issuer_actual
债券初始面值 -> par
债券最新面值 -> latestpar
发行总额 -> issueamount
各级发行总额 -> tranche
各级占比 -> trancheratio
债券余额 -> outstandingbalance
国债余额（做市后） -> tbondbalance
起息日期 -> carrydate
计息截止日 -> carryenddate
到期日期 -> maturitdate
发行期限（兑付日，年） -> term
发行期限（每个行权日，年） -> term2
实际到期日 -> actualmaturitydate
利率类型 -> interesttype
浮息基准 -> floatingreference
票面利率（发行时） -> couponrate
利率说明 -> coupontxt
计息方式 -> paymenttype
计息基准 -> actualbenchmark
息票品种 -> coupon
凭证类别 -> form
每年付息次数 -> interestfrequency
年付息日 -> paymentdate
付息日说明 -> coupondatetxt
是否免税 -> taxfree
税率 -> taxrate
市价类型 -> mktpricetype
市价类型（支持历史） -> mktpricetype_suph
兑付日 -> redemption_beginning
兑付登记日 -> redemption_regbeginning
兑付费率 -> redemption_feeration
付息公告日 -> paydiscdate
偿还方式 -> repaymentmethod
偿付顺序 -> paymentorder
资产是否出表 -> isassetout
计划管理人 -> abs_spv
原始权益人 -> issuer
单一债务主体中文名称 -> singleissuer
基础资产/标的类型 -> us_type
ABS基础资产分类 -> abs_underlyingtype
债务主体（银行）类型 -> issuer_banktype
最新交易日期 -> repo_lastestdate
承销团成员 -> abs_creditnormal
主体行业(2004) -> abs_industry
主体性质 -> abs_industry1
主体地区 -> abs_province
受托机构 -> abs_agency_trustee1
项目名称 -> abs_fullnamepro
项目简称 -> abs_namepro
项目代码 -> abs_projectcode
还本方式 -> abs_payback
基础债务人 -> abs_borrower
基础债务人行业 -> abs_coreindustry
基础债务人地区 -> abs_coreprovince
基础债务人性质 -> abs_coreproperty
早偿率 -> abs_recommendcpr
加权平均期限 -> abs_weightedaveragematuritywithprepay
信用支持 -> abs_creditsupport
项目余额 -> abs_dealoutststandingamount
固定资金成本 -> abs_fiexdcapitalcostrate
次级每期收益率上限 -> abs_capyieldpertermofSUB
自持比例 -> abs_selfsustainingproportion
法定到期日 -> abs_legalmaturity
支付日 -> abs_paymentdate
早偿预期到期日 -> abs_expectedmaturitywithprepay
首次支付日 -> abs_firstpaymentdate
初始起算日 -> abs_cutoffdate
清算起始日 -> abs_startdateofassetclearing
清算结束日 -> abs_enddateofassetclearing
差额支付承诺人 -> abs_defiguarantor
专项计划托管人 -> abs_trustee
资产服务机构 -> abs_assetserviceagency
流动性支持承诺人 -> abs_liquiguarantor
会计处理 -> accounttreatment
是否可担保交收 -> guaranteeSettlement
发行规则 -> issuerules
发行结构 -> issuestructure
初始资产池金额统计 -> abs_initialpoolbalance
初始资产池数量统计 -> abs_initialpoolnumber
初始资产池期限统计 -> abs_initialpoollife
初始资产池利率统计 -> abs_initialpoolrate
资产池归集时间 -> abs_collectionenddate

【3】基本资料
------------------------------
早偿预期到期日 -> abs_expectedmaturitywithprepay
首次支付日 -> abs_firstpaymentdate
初始起算日 -> abs_cutoffdate
清算起始日 -> abs_startdateofassetclearing
清算结束日 -> abs_enddateofassetclearing
差额支付承诺人 -> abs_defiguarantor
专项计划托管人 -> abs_trustee
资产服务机构 -> abs_assetserviceagency
流动性支持承诺人 -> abs_liquiguarantor
会计处理 -> accounttreatment
是否可担保交收 -> guaranteeSettlement
发行规则 -> issuerules
发行结构 -> issuestructure
初始资产池金额统计 -> abs_initialpoolbalance
初始资产池数量统计 -> abs_initialpoolnumber
初始资产池期限统计 -> abs_initialpoollife
初始资产池利率统计 -> abs_initialpoolrate
资产池归集时间 -> abs_collectionenddate
期末剩余资产池笔数 -> abs_endpoolnumber
期末剩余资产池余额 -> abs_endpoolbalance
期末资产池剩余期限 -> abs_endweightedaveragelife
期末资产池加权平均利率 -> abs_endweightedaveragerate
累计违约率 -> abs_cumdefaultrate
严重拖欠率 -> abs_delinquencyrate2
期间早偿率 -> abs_periodprepayrate
年化早偿率（单月年化） -> abs_annualprepayrate
年化违约率（单月年化） -> abs_annualdefaultrate
Wind债券一级分类（旧） -> windl1type
Wind债券二级分类（旧） -> windl2type
中债债券一级分类 -> chinabondl1type
中债债券二级分类 -> chinabondl2type
NAFMII债券二级分类 -> nafmiiL2type
NAFMII债券一级分类 -> nafmiiL1type
上清所债券分类 -> shclearl1type
地方债类型 -> munitype
是否城投债(Wind) -> municipalbondWind
城投行政级别(Wind) -> cityinvestmentbondgeoWind
是否城投债(YY) -> municipalbondYY
城投行政级别(YY) -> issuer_cityinvestmentbondgeoYY
债券非市场化发行指数 -> bondindexbuzhoumountain
主体非市场化发行指数 -> corporateindexbuzhoumountain
是否跨市场交易 -> multimktornot
是否次级债 -> subordinateornot
是否混合资本债券 -> mixcapital
是否增发 -> issueadditional
增发债对应原债券 -> additionalto
是否永续债 -> perpetualornot
是否ESG(绿色)债券 -> greenbond
是否PR债 -> prornot
是否绿债 -> greenbondnornot
是否熊猫债 -> pandabonds
适当性管理 -> investorad
担保交收 -> guaranteeornot
基准利率 -> baserate
固定利差 -> spread
基准利率确定方式 -> cmbir
首个定价日 -> issue_firstpricedate
票面利率（当期） -> couponrate2
票面利率（指定日期） -> couponrate3
基准利率（发行时） -> baserate2
基准利率（指定日期） -> baserate3
行权后利差 -> spread2
保底利率 -> interestfloor
特殊条款 -> clause
特殊条款（缩写） -> clauseabbr
指定条款文字 -> clauseitem
含权债首个行权期（年） -> execmaturityembedded
含权债期限特殊说明 -> eobspecialinstrutions
提前还本日 -> prepaymentdate
提前还本比例 -> prepayportion
提前还本方式 -> prepaymethod
赎回日 -> redemptiondate
回售日 -> repurchasedate
赎回价格 -> redemptionprice
回售价格 -> repurchaseprice
回售代码 -> putcode
回售登记起始日 -> repurchasebegindate
回售登记截止日 -> repurchaseenddate
行权资金到账日 -> fundarrialdate
票面利率调整上限 -> couponadj_max
票面利率调整下限 -> couponadj_min
赎回登记日 -> callrecdate
担保人 -> agency_guarantor
担保人公司简介 -> agency_guarantorbriefing
担保人公司属性 -> agency_guarantornature
担保方式 -> agency_grnttype
担保期限 -> guarterm
担保范围 -> guarrange
担保条款文字 -> agency_grntrange
再担保人 -> agency_reguarantor
反担保情况 -> counterguar
标准券折算比例 -> rateofstdbnd
标准券折算金额（每百元面值） -> cvntperhundred
质押券代码 -> collateralcode
质押券简称 -> collateralname
是否可质押 -> repo_pcntbond
报价式回购折算率（中证指数） -> rateofstdbndcsi
ESG债券募集金额认定比例 -> esg_proportion
ESG债券认证结论 -> esg_conclusion
ESG债券效益评估 -> esg_Benefit_evaluation
ESG债券认证标准 -> esg_approval
省份（穿透信用主体） -> issuer_actual_province
城市（穿透信用主体） -> issuer_actual_city
注册地（穿透信用主体） -> issuer_actual_regaddress
办公地址（穿透信用主体） -> issuer_actual_office
公司属性（穿透信用主体） -> issuer_actual_nature1
所属Wind行业名称（穿透信用主体）(2004) -> issuer_actual_windindustry
是否随存款利率调整 -> clause_interest_5
是否有利息补偿 -> clause_interest_8
补偿利率说明 -> clause_interest_6
补偿利率 -> clause_interest_compensationinterest
补偿利率（公布） -> clause_compensationinterest
利息处理方式 -> clause_processmodeinterest
正股代码 -> underlyingcode
正股简称 -> underlyingname
相对转股期 -> clause_conversion_2_relativeswapsharemonth
自愿转股起始日期 -> clause_conversion_2_swapsharestartdate
自愿转股终止日期 -> clause_conversion_2_swapshareenddate
是否强制转股 -> clause_conversion_2_isforced
强制转股日 -> clause_conversion_2_forceconvertdate
强制转股价格 -> clause_conversion_2_forceconvertprice
转股价格 -> clause_conversion2_swapshareprice
转股代码 -> clause_conversion_code
转换比例 -> clause_conversion2_conversionproportion
未转股余额 -> clause_conversion2_bondlot
未转股比例 -> clause_conversion2_bondproportion
转股价随派息调整 -> clause_conversion_2_conversionproportion
转股条款 -> clause_conversion2_tosharepriceadjustitem
特别向下修正条款全文 -> clause_reset_item
是否有特别向下修正条款 -> clause_reset_isexitreset
特别修正起始时间 -> clause_reset_resetstartdate
特别修正结束时间 -> clause_reset_resetperiodenddate
重设触发计算最大时间区间 -> clause_reset_resetmaxtimespan
重设触发计算时间区间 -> clause_reset_resettimespan
触发比例 -> clause_reset_resettriggerratio
是否为算术平均价 -> TLTX
修正价格底线说明 -> clause_reset_stockpricelowestlimit
修正次数限制 -> clause_reset_resettimeslimit
时点修正条款全文 -> clause_reset_timepointclause
相对赎回期 -> clause_calloption_relativecalloptionperiod
每年可赎回次数 -> clause_calloption_redemptiontimesperyear
条件赎回起始日期 -> clause_calloption_conditionalredeemstartdate
条件赎回截止日期 -> clause_calloption_conditionalredeemenddate
赎回触发计算最大时间区间 -> clause_calloption_redeemmaxspan
赎回触发计算时间区间 -> clause_calloption_redeemspan
赎回触发比例 -> clause_calloption_triggerproportion
赎回价格 -> clause_calloption_redemptionprice
赎回价格说明 -> clause_calloption_redemptionmemo
利息处理 -> clause_calloption_interestdisposal
赎回条款 -> clause_calloption_redeemitem
是否有时点赎回条款 -> clause_calloption_iswithtimeredemptionclause
时点赎回数 -> clause_calloption_timeredemptiontimes
时点赎回条款全文 -> clause_calloption_redeemclause
有条件赎回价 -> conditionalcallprice
到期赎回价 -> maturitycallprice
赎回触发价 -> clause_calloption_triggerprice
赎回登记日 -> clause_calloption_recorddate
赎回公告日 -> clause_calloption_noticedate
强赎提示公告日 -> clause_calloption_indicativedateY
不强赎提示公告日 -> clause_calloption_indicativedateN
最后交易日 -> war_lasttradedate
相对回售期 -> clause_putoption_putbackperiodobs
条件回售起始日期 -> clause_putoption_conditionalputbackstartenddate
条件回售截止日期 -> clause_putoption_conditionalputbackenddate
回售触发计算最大时间区间 -> clause_putoption_putbacktriggermaxspan
回售触发计算时间区间 -> clause_putoption_putbacktriggerspan
回售触发比例 -> clause_putoption_redeem_triggerproportion
回售价格 -> clause_putoption_resellingprice
回售价格说明 -> clause_putoption_resellingpriceexplaination
每年回售次数 -> clause_putoption_putbacktimesperyear
利息处理 -> clause_putoption_interestdisposing
条件回售条款全文 -> clause_putoption_sellbackitem
无条件回售期 -> clause_putoption_putbackperiod
无条件回售起始日期 -> clause_putoption_putbackstartdate
无条件回售结束日期 -> clause_putoption_putbackenddate
无条件回售价 -> clause_putoption_putbackprice
无条件回售条款 -> clause_putoption_putbackclause
时点回售数 -> clause_putoption_timeputbacktimes
时点回售条款全文 -> clause_putoption_timeputbackclause
附加回售价格说明 -> clause_putoption_additionalpricememo
附加回售条件 -> clause_putoption_putbackadditionalcondition
有条件回售价 -> conditionalputprice
回售触发价 -> clause_putoption_triggerprice
回售公告日 -> clause_putoption_noticedate
发行时债项评级 -> creditrating
发行时主体评级 -> issuer_rating
发行时主体评级展望 -> issuerratingoutlook
主体委托评级机构 -> rate_creditratingagency
发行时担保人评级 -> rate_beginguarantor
发债主体评级机构 -> issurercreditratingcompany
最新债项评级日期 -> rate_latest
最新债项评级日期（指定机构） -> rate_latest1
最新债项评级变动方向 -> rate_changesofrating
最新债项评级评级类型 -> rate_style
主体评级（主评机构） -> latestissurercreditrating
主体评级（主评机构(ABS穿透）) -> latestissurercreditrating_actual
主体最新评级展望 -> ratingoutlooks
发行人最新评级日期 -> latestissurercreditratingdate
发行人最新评级日期（指定机构） -> latestratingdate
主体最新评级变动方向 -> rate_lateissuerchng
最新主体评级评级类型 -> latestissurercreditratingtype
最新最低主体评级 -> lowestissurercreditrating
担保人最新评级 -> latestratingofguarantor
担保人最新评级展望 -> rate_lateguarantorfwd
担保人最新评级日期 -> rate_lateguarantordate
担保人最新评级变动方向 -> rate_lateguarantorchng
债项评级（主评机构）（待废弃） -> amount
债项评级 -> rate_ratebond
债项评级变动方向 -> rate_chngbond
债项评级机构 -> rate_agencybond
主体评级 -> latestissurercreditrating2
主体评级展望 -> rate_fwdissuer
主体评级变动方向 -> rate_chngissuer
主体评级评级机构 -> rate_agencyissuer
担保人评级 -> rate_rateguarantor
担保人评级展望 -> rate_fwdguarantor
担保人评级变动方向 -> rate_chngguarantor
担保人评级评级机构 -> rate_agencyguarantor
指定日主体评级（主评机构） -> rate_issuer
历史债项评级 -> rate_former
历史主体评级（主评机构） -> rate_issuerformer
债项国际评级 -> ratebond2
主体国际评级 -> issuer2
最新授信额度 -> credit_line
最新已使用授信额度 -> credit_lineused
最新未使用授信额度 -> credit_lineunused
历史已使用授信额度 -> credit_lineused2
历史授信额度 -> credit_formerline
最新授信日期 -> credit_linedate
最新担保余额 -> guar_latestbalance
最新对内担保余额 -> guar_latestinwards
最新对外担保余额 -> guar_latestoutwards
历史担保余额 -> guar_formerbalance
对内担保余额 -> guar_formerinwards
对外担保余额 -> guar_formeroutwards
实际可用剩余额度 -> dcm_unuesdamount
已使用注册额度 -> dcm_uesdamount
首期发行截止日 -> dcm_firstissueenddate
未使用注册会议日期 -> dcm_meetingdata
未使用额度有效期 -> dcm_expirationdata
最新注册文件编号 -> dcm_number
未使用额度主承销商 -> dcm_underwriter
历史累计注册额度 -> dcm_accumamount
存量债券余额 -> fina_totalamount
存量债券余额（支持历史） -> final_totalamout_anytime
存量债券余额（按期限） -> fina_mat
存量债券数目 -> fina_remainingnumber
回购代码 -> repo_code
标的债券 -> repo_ubond
回购类型 -> repo_type
回购天数 -> repo_days
凭证起始日 -> crm_carrydate
标的实体交易代码 -> crm_subjectcode
履约保障机制 -> crm_performguarantee
信用事件 -> crm_creditevent
债券信用状态 -> credit_bondcreditstatus
发行人首次违约日 -> issuerfirstdefaultdate
风险状态 -> riskstate
登记机构 -> crm_registeragency
标的实体 -> crm_subject
发布机构 -> crm_issuer
发行时标的债券余额 -> crm_ubondoustandingamount
簿记建档日 -> crm_bookkeepingdate
付费方式 -> crm_paymentterms
创设价格 -> crm_startingprice
创设批准文件编号 -> crm_permissionnumber
凭证登记日 -> crm_dateofrecord

【4】基本资料
------------------------------
基金全称（英文） -> fund_fullnameen
基金场内简称 -> fund_exchangeshortname
基金扩位场内简称 -> fund_exchangeshortnameextend
发行机构自编简称 -> fund_issuershortname
成立年限 -> fund_existingyear
基金最短持有期 -> fund_minholdingperiod
基金存续期 -> fund_ptmyear
剩余存续期 -> fund_ptmday
业绩比较基准 -> fund_benchmark
业绩比较基准变更说明 -> fund_changeofbenchmark
基准指数代码 -> fund_benchindexcode
投资目标 -> fund_investobject
投资范围 -> fund_investscope
投资品种比例限制 -> fund_investmentproportion
港股通股票投资比例说明 -> fund_hkscinvestmentproportion
投资理念 -> fund_investconception
投资区域 -> fund_investmentregion
主要投资区域说明 -> fund_investingregiondescription
面值 -> fund_parvalue
是否初始基金 -> fund_initial
是否分级基金 -> fund_structuredfundornot
是否定期开放基金 -> fund_regulopenfundornot
是否FOF基金 -> fund_foffundornot
是否使用侧袋机制 -> fund_sidepocketfundornot
是否定制基金 -> customizedfundornot
产品异常状态 -> fund_exceptionstatus
净值异常涨跌幅说明 -> fund_abnormalnavfluctuation
封闭运作期 -> fund_operateperiod_cls
预期收益率（文字） -> expectedyield
基金转型说明 -> fund_fundtransition
基金估值方法 -> fund_valuationmethod
风险收益特征 -> fund_riskreturn_characters
巨额赎回条款 -> massredemptionprovision
市场风险提示 -> marketrisk
管理风险提示 -> managementrisk
技术风险提示 -> technicalrisk
赎回风险提示 -> redemptionrisk
其他风险提示 -> otherrisks
基金前端代码 -> fund_frontendcode
基金后端代码 -> fund_backendcode
基金初始代码 -> fund_initialcode
关联基金代码 -> fund_relatedcode
基金业协会编码 -> fund_AMACcode
理财产品登记编码 -> fund_bwmp_recordcode
发行机构自编代码 -> fund_issuercode
理财产品交易所代码 -> fund_exchangecode
机构间私募产品报价系统编码 -> fund_pequotationcode
基金成立日 -> fund_setupdate
基金到期日 -> fund_maturitydate_2
基金暂停运作日 -> fund_date_suspension
基金恢复运作日 -> fund_date_resumption
开始托管日期 -> fund_custstartdate
托管结束日期 -> fund_custenddate
互认基金批复日期 -> fund_recognitiondate
预计封闭期结束日 -> fund_expectedendingday
预计下期开放日 -> fund_expectedopenday
定开基金封闭起始日 -> fund_startdateofclosure
定开基金上一开放日 -> fund_lastopenday
定开基金开放日（支持历史） -> fund_opendays
定开基金已开放次数 -> fund_numofopendays
上市公告数据截止日期 -> listdatadate
基金管理人 -> fund_mgrcomp
基金托管人 -> fund_custodianbank
基金注册与过户登记人 -> issue_registrar
财务顾问 -> issue_financeconsultant
银行理财发行人 -> fund_wmissuer
境外投资顾问 -> fund_foreigninvestmentadvisor
境外托管人 -> fund_foreigncustodian
审计机构（支持历史） -> auditor2
律师事务所 -> fund_counselor
一级交易商 -> fund_primarydealers
Wind产品类型 -> fund_prodtype_wind
Wind封闭式开放式基金分类 -> fund_prodtypeoc_wind
基金类型 -> fund_type
投资类型（一级分类） -> fund_firstinvesttype
投资类型（二级分类） -> fund_investtype
投资类型 -> fund_investtype2
投资类型（支持历史） -> fund_investtype_anytime
投资类型（英文） -> fund_investtypeeng
基金风险等级 -> fund_risklevel
基金风险等级（公告口径） -> fund_risklevelfiling
基金分级类型 -> fund_smftype2
同类基金数量 -> fund_similarfundno
所属主题基金类别 -> fund_themetype
所属主题基金类别(Wind概念) -> fund_themetype_concept
所属主题基金类别(Wind行业) -> fund_themetype_industry
所属主题基金类别(Wind股票指数) -> fund_themetype_index
第三方基金分类 -> fund_thirdpartyfundtype
管理费率 -> fund_managementfeeratio
管理费率（支持历史） -> fund_managementfeeratio2
是否收取浮动管理费 -> fund_floatingmgntfeeornot
浮动管理费率说明 -> fund_floatingmgntfeedescrip
托管费率 -> fund_custodianfeeratio
托管费率（支持历史） -> fund_custodianfeeratio2
销售服务费率 -> fund_salefeeratio
销售服务费率（支持历史） -> fund_salefeeratio2
最高申购费率 -> fund_purchasefeeratio
最高赎回费率 -> fund_redemptionfeeratio
认购费率 -> fund_subscriptionfee
认购费率（支持历史） -> fund_subscriptionfee2
最高认购费率 -> fund_highestsubscriptionfee
申购费率 -> fund_purchasefee
申购费率（支持历史） -> fund_purchasefee2
赎回费率 -> fund_redemptionfee
赎回费率（支持历史） -> fund_redemptionfee2
指数使用费率 -> fund_indexusagefeeratio
申购费率上限 -> fund_pchredm_pchmaxfee
赎回费率上限 -> fund_pchredm_maxredmfee
申购赎回简称 -> fund_purchaseandredemptionabbreviation
申购赎回状态 -> fund_dq_status
申购状态 -> fund_pchmstatus
赎回状态 -> fund_redmstatus
申购起始日 -> fund_pchredm_pchstartdate
单日大额申购限额 -> fund_pchredm_largepchmaxamt
申购金额下限（场外） -> fund_pchredm_pchminamt
申购金额下限（场内） -> fund_pchredm_pchminamt_floor
赎回起始日 -> fund_redmstartdate
单笔赎回份额下限 -> fund_pchredm_redmminamt
申购确认日 -> fund_pchconfirmdate
赎回确认日 -> fund_redmconfirmdate
赎回划款日 -> fund_redmarrialdate
基金经理 -> fund_fundmanageroftradedate
基金经理（现任） -> fund_fundmanager
基金经理（历任） -> fund_predfundmanager
基金经理（成立） -> fund_inceptionfundmanager
任职期限最长的现任基金经理 -> fund_manager_longestfundmanager
任职期限最长的在任基金经理（支持历史） -> fund_longestfundmanager_hist
出生年份 -> fund_manager_birthyear
年龄 -> fund_manager_age
学历 -> fund_manager_education
国籍 -> fund_manager_nationality
简历 -> fund_manager_resume
性别 -> fund_manager_gender
任职日期 -> fund_manager_startdate
任职天数 -> fund_manager_onthepostdays
基金经理年限 -> fund_manager_managerworkingyears
基金经理平均年限 -> fund_averageworkingyears
基金经理最大年限 -> fund_maxworkingyears
证券从业日期 -> fund_manager_startdateofmanagercareer
历任基金数 -> fund_manager_previousfundno
任职基金数 -> fund_manager_fundno
任职基金代码 -> fund_manager_fundcodes
任职基金总规模 -> fund_manager_totalnetasset
任职基金总规模（支持历史） -> fund_manager_totalnetasset2
离职日期 -> fund_manager_enddate
离任原因 -> fund_manager_resignationreason
投资经理背景 -> fund_manager_background
代管基金经理说明 -> fund_manager_proxyformanager
任职基金获奖记录 -> fund_manager_awardrecord
几何平均年化收益率 -> fund_manager_geometricannualizedyield
算术平均年化收益率 -> fund_manager_arithmeticannualizedyield
超越基准总回报 -> fund_manager_totalreturnoverbenchmark
超越基准几何平均年化收益率 -> fund_manager_geometricavgannualyieldoverbench
超越基准算术平均年化收益率 -> fund_manager_arithmeticavgannualyieldoverbench
任职年化回报 -> NAV_periodicannualizedreturn
任职年化回报（支持历史） -> NAV_periodicannualizedreturn_hist
任期最大回报 -> fund_manager_maxreturn
现任基金最佳回报 -> fund_manager_bestperformance
任期最大回撤 -> fund_manager_maxdrawdown
基金管理人简称 -> fund_corp_fundmanagementcompany
基金管理人英文名称 -> fund_corpnameeng
基金管理人注册城市 -> fund_corpcity
基金管理人注册地址 -> fund_corpaddress
基金管理人办公地址 -> fund_corpoffice
基金管理人法人代表 -> fund_corpchairman
基金管理人总经理 -> fund_corpmanager
基金管理人电话 -> fund_corpphone
基金管理人传真 -> fund_corpfax
基金管理人电子邮箱 -> fund_corpemail
基金管理人注册资本 -> fund_corpregisteredcapital
基金管理人成立日期 -> fund_corpestablishmentdate
基金管理人邮编 -> fund_corpzip
基金管理人主页 -> fund_corpwebsite
基金管理人在管规模合计（非货币） -> prt_nonmoneynetassets
基金管理人在管规模合计 -> prt_fundcototalnetassets
基金管理人在管规模合计排名 -> prt_fundcototalnetassetsranking
基金管理人在管规模合计变动率 -> prt_fundcotnachangeratio
旗下基金数 -> fund_corp_fundno
基金经理数 -> fund_corp_fundmanagersno
基金经理成熟度 -> fund_corp_fundmanagermaturity
基金管理人重仓股票名称 -> corp_topstockname
基金管理人重仓股票代码 -> corp_topstockcode
基金管理人重仓股票Wind代码 -> corp_topstockwindcode
基金管理人重仓股票数量 -> corp_topstockquantity
基金管理人重仓股票市值 -> corp_topstockvalue
基金管理人重仓股票市值占股票投资市值比 -> corp_heavilyheldstocktostock
基金管理人重仓股票市值占资产净值比 -> corp_heavilyheldstocktonav
基金管理人重仓股票持仓变动 -> corp_topnstockholdingchange
基金管理人重仓债券名称 -> corp_topbondname
基金管理人重仓债券代码 -> corp_topbondcode
基金管理人重仓债券Wind代码 -> corp_topbondwindcode
基金管理人重仓债券数量 -> corp_topbondquantity
基金管理人重仓债券市值 -> corp_topbondvalue
基金管理人重仓债券市值占债券投资市值比 -> corp_heavilyheldbondtobond
基金管理人重仓债券市值占资产净值比 -> corp_heavilyheldbondtonav
基金管理人前N名重仓债券市值占资产净值比 -> corp_topnbondtonav
基金管理人重仓债券持仓变动 -> corp_topnbondholdingchange
跟踪指数代码 -> fund_trackindexcode
跟踪指数名称 -> fund_trackindexname
关联ETFWind代码 -> fund_etfwindcode
ETF关联联接基金代码 -> fund_etf_feedercode
日均跟踪偏离度阈值（业绩基准） -> fund_trackdeviation_threshold
年化跟踪误差阈值（业绩基准） -> fund_trackerror_threshold
ETF网上现金发售代码 -> issue_onlinecashofferingsymbol
ETF一级市场基金代码 -> issue_firstmarketfundcode
ETF网上现金认购起始日 -> fund_networkcashbuystartdate
ETF网上现金认购截止日 -> fund_networkcashbuyenddate
ETF网上现金认购份额下限 -> fund_networkcashbuysharedownlimit
ETF网上现金认购份额上限 -> fund_networkcashbuyshareuplimit
ETF网下现金认购起始日 -> fund_offnetworkbuystartdate
ETF网下现金认购截止日 -> fund_offnetworkbuyenddate
ETF网下现金认购份额下限 -> fund_offnetworkcashbuysharedownlimit
ETF网下股票认购起始日 -> fund_offnetworkstockbuystartdate
ETF网下股票认购截止日 -> fund_offnetworkstockbuyenddate
ETF网下股票认购份额下限 -> fund_offnetworkstockbuysharedownlimit
ETF上市日期 -> fund_etflisteddate
ETF上市交易份额 -> issue_etfdealshareonmarket
ETF基金份额折算日 -> fund_fundsharetranslationdate
ETF基金份额折算比例 -> fund_fundsharetranslationratio
ETF申购赎回现金差额 -> fund_etfpr_cashbalance
ETF申购赎回最小申购赎回单位 -> fund_etfpr_minnav
ETF申购赎回最小申购赎回单位资产净值 -> fund_etfpr_minnav_unit
ETF申购赎回预估现金部分 -> fund_etfpr_estcash
ETF申购赎回现金替代比例上限(%) -> fund_etfpr_cashratio
ETF申赎清单申购上限 -> fund_etfpr_maxpurchase
ETF申赎清单赎回上限 -> fund_etfpr_minredemption
ETF申购赎回清单当天净申购上限 -> fund_etfpr_maxnetpurchase
ETF申购赎回清单当天净赎回上限 -> fund_etfpr_maxnetredemption
ETF申购赎回清单单个证券账户净申购上限 -> fund_etfpr_maxnetpurchasepersecurityaccount
ETF申购赎回清单单个证券账户净赎回上限 -> fund_etfpr_maxnetredemptionpersecurityaccount
ETF申购赎回清单单个证券账户累计可申购上限 -> fund_etfpr_maxpurchasepersecurityaccount
ETF申购赎回清单单个证券账户累计可赎回上限 -> fund_etfpr_maxredemptionpersecurityaccount
分级基金类别 -> fund_smftype
分级基金母基金代码 -> fund_smfcode
分级基金优先级代码 -> fund_smfacode
分级基金普通级代码 -> fund_smfbcode
拆分比率 -> fund_splitratio
分级份额占比 -> fund_subshareproportion
初始杠杆 -> fund_initiallever
约定年收益率表达式 -> fund_aayeildinfo
是否配对转换 -> fund_pairconversion
定期折算周期 -> fund_discountperiod
定期折算条款 -> fund_discountmethod
向上触点折算条款 -> fund_updiscount
向下触点折算条款 -> fund_downdiscount
保本周期 -> fund_guaranteedcycle
保本费率 -> fund_guaranteedfeerate
保证人 -> fund_warrantor
保证人简介 -> fund_warrantorintroduction
保本触发收益率 -> fund_guaranteedtriggerratio
保本触发机制说明 -> fund_guaranteedtriggertxt
保本周期起始日期 -> fund_guaranteedcycle_startdate

【5】基本资料
------------------------------
计划类型（券商集合理财） -> fund_plantype
是否提取业绩报酬（券商集合理财） -> fund_performancefeeornot
业绩报酬提取方法 -> fund_performancefeemethod
管理费说明 -> fund_mgntfeeexplain
规模同类排名（券商集合理财） -> fund_qsimilarproductsimilarranking
信托类别（信托） -> trust_type
信托投资领域 -> trust_investfield
信托产品类别 -> trust_sourcetype
受托人固定管理费率（信托） -> fund_trusteemgntfee
投资顾问固定管理费率（信托） -> fund_invadvisermgntfee
预计年收益率（信托） -> fund_expectedrateofreturn
是否结构化产品（信托） -> fund_structuredornot
受托人（信托） -> fund_trustee
证券经纪人（信托） -> fund_securitiesbroker
发行地（信托） -> fund_issuingplace
浮动收益说明（信托） -> fund_floatingratenote
一般受益权金额（信托） -> fund_generalbeneficialamount
优先受益权金额（信托） -> fund_prioritybeneficialamount
发行信托合同总数（信托） -> fund_issuedcontractamount
信用增级情况 -> advancecredit_desc
预期收益率说明 -> anticipateyield_desc
信托项目关联企业名称 -> trust_relatedfirm
销售起始日期 -> fund_substartdate
销售截止日期 -> fund_subenddate
目标规模 -> fund_targetscale
实际发行规模 -> fund_actualscale
有效认购户数 -> fund_effsubscrholederno
最低参与金额 -> fund_minbuyamount
追加认购最低金额 -> fund_minaddbuyamount
管理人参与金额 -> fund_managersbuyamount
开放日说明 -> fund_opendayillus
封闭期说明 -> fund_closedayillus
投资策略分类（一级）（私募） -> fund_firstinveststrategy
投资策略分类（二级）（私募） -> fund_secondinveststrategy
产品发行渠道 -> issue_channel
投资顾问 -> fund_investmentadvisor
基金净值更新频率 -> NAV_updatefrequency
基金特别提示信息 -> fund_spenotice
协会备案管理人在管规模 -> fund_managescaleinterval
管理人是否存在诚信信息 -> fund_managerintergrity
管理人是否存在提示信息 -> fund_managernoticeinfo
是否保本 -> fund_guaranteedornot
银行理财风险等级（银行） -> fund_lcrisklevel
银行理财风险等级(Wind) -> fund_lcrisklevelwind
产品运作方式 -> fund_operationmode
业务模式 -> fund_businessmode
运作模式 -> fund_operationtype
发行人类型 -> fund_issuertype
期限类型 -> fund_periodtype
收益类型 -> fund_yieldtype
收益起始日 -> fund_returnstartdate
收益终止日 -> fund_returnenddate
实际运作期限 -> fund_actualduration
委托金额上限 -> fund_maxsubscripamount
到期实际年化收益率 -> fund_actualannualyield
实际到期日 -> fund_actualmaturitydate
付息方式说明 -> fund_interestpaymethod
资金到账天数 -> fund_fundarrivaldays
是否可提前终止 -> fund_earlyterminationornot
提前终止条件 -> fund_cndpretermination
申购赎回条件 -> fund_cndpurchredemption
是否可质押 -> fund_pledgableornot
收益挂钩标的 -> fund_underlyingtarget
主要风险点 -> fund_mainrisk
项目属性 -> fund_reitsrproperty
资产类型 -> fund_reitstype
项目介绍 -> fund_reitsinfo
REITs上市日期 -> fund_reitslisteddate
询价区间上限 -> fund_reitspricemax
询价区间下限 -> fund_reitspricemin
战略发售起始日 -> fund_reitssistdate
战略发售截止日 -> fund_reitssiendate
战略投资方认购份额 -> fund_reitssisharesub
战略配售份额 -> fund_reitssishare
战略投资方认购比例 -> fund_reitssiratio
战略配售份额占比 -> fund_reitssisharera
原始权益人或其同一控制下关联方配售份额（首发） -> fund_reitsoriginalequityshare
其他战略投资者配售份额 -> fund_reitsothersishare
原始权益人或其同一控制下关联方配售份额占总份额比例（首发） -> fund__reitsoriginalequityratio
网下发售起始日 -> fund_reitsoffstdate
网下发售截止日 -> fund_reitsoffendate
网下配售份额 -> fund_reitsoffshare
网下投资方认购比例 -> fund_reitsoiratio
网下配售份额占比 -> fund_reitsoffsharera
公众发售起始日 -> fund_reitspbstdate
公众发售截止日 -> fund_reitspbendate
公众初始发售份额 -> fund_reitspishare
公众配售份额 -> fund_reitspbshare
公众投资方认购比例 -> fund_reitspiratio
公众配售份额占比 -> fund_reitspbsharera
项目运营风险 -> fund_reitsoprisk
资产评估机构 -> fund_reitsvaag
资产名称 -> fund_reitsasname
资产所在地 -> fund_reitslocation
项目公司名称 -> fund_reitscomname
原始权益人 -> fund_reitsoriginal
原始权益人企业性质 -> fund_reitsorcom
网下机构自营投资账户配售数量 -> fund_reitspis
网下机构自营投资账户配售金额 -> fund_reitspim
网下机构自营投资账户配售份额占比 -> fund_reitspir
网下私募基金配售数量 -> fund_reitspfs
网下私募基金配售金额 -> fund_reitspfm
网下私募基金配售份额占比 -> fund_reitspfr
网下保险资金投资账户配售数量 -> fund_reitsiss
网下保险资金投资账户配售金额 -> fund_reitsism
网下保险资金投资账户配售份额占比 -> fund_reitsisr
网下基金公司或其资管子公司配售数量 -> fund_reitsfms
网下基金公司或其资管子公司配售金额 -> fund_reitsfmm
网下基金公司或其资管子公司配售份额占比 -> fund_reitsfmr
网下基金公司或其资管计划配售数量 -> fund_reitsfmas
网下基金公司或其资管机构配售金额 -> fund_reitsfmam
网下基金公司或其资管计划配售份额占比 -> fund_reitsfmar
网下集合信托计划配售数量 -> fund_reitstrs
网下集合信托计划配售金额 -> fund_reitstrm
网下集合信托计划配售份额占比 -> fund_reitstrr
网下证券公司集合资产管理计划配售数量 -> fund_reitsscs
网下证券公司集合资产管理计划配售金额 -> fund_reitsscm
网下证券公司集合资产管理计划配售份额占比 -> fund_reitsscr
网下QFII投资账户配售数量 -> fund_reitsqfs
网下QFII投资账户配售金额 -> fund_reitsqfm
网下QFII投资账户配售份额占比 -> fund_reitsqfr
网下证券公司单一资产管理计划配售数量 -> fund_reitsscss
网下证券公司单一资产管理计划配售金额 -> fund_reitsscsm
网下证券公司单一资产管理计划配售份额占比 -> fund_reitsscsr
限售份额 -> fund__reitslimitedshare
场内限售份额 -> fund__reitslimitedshareft
限售份额预计上市流通日期 -> reits_explistd
限售份额剩余限售期 -> reits_restlimd
初始折现率 -> fund_reitsdisc
初始内部收益率 -> fund_reitsirr
开始交易日 -> ftdate
开始交易日（支持历史） -> ftdate_new
最后交易日 -> lasttrade_date
最后交易日（支持历史） -> Itdate_new
最后交割日 -> lastdelivery_date
最后交割日（支持历史） -> Iddate_new
交割月份 -> dlmonth
挂牌基准价 -> lprice
期货交易手续费 -> transactionfee
期货交割手续费 -> deliveryfee
期货平今手续费 -> todaypositionfee
交易品种 -> sccode
交易保证金 -> margin
期货多头保证金（支持历史） -> long_margin
期货空头保证金（支持历史） -> short_margin
报价单位 -> punit
涨跌幅限制 -> changelt
涨跌幅限制（支持历史） -> changelt_new
最小变动价位 -> mfprice
最小变动价位（支持历史） -> mfprice1
标准合约上市日 -> contract_issuedate
合约乘数 -> contractmultiplier
合约月份说明 -> cdmonths
交易时间说明 -> thours2
最后交易日说明 -> Itdated
交割日期说明 -> ddate
最初交易保证金 -> ftmargins
月合约代码 -> trade_hiscode
期货合约所属行业 -> industry_fu
期权代码（指定行权价） -> options_tradecode
平值期权代码 -> atmcode
连续平值期权代码 -> cont_atm_code
主力平值期权代码 -> active_atm_code
期权交易代码 -> tradecode
标的代码 -> us_code
标的Wind代码 -> underlyingwindcode
期权主力标的代码 -> op_active_undly
标的简称 -> us_name
基础资产/标的类型 -> us_type
期权类型 -> exe_mode
行权方式 -> exe_type
行权价格 -> exe_price
期权维持保证金（支持历史） -> maint_margin
合约乘数 -> exe_ratio
总存续期 -> totaltm
起始交易日期 -> startdate
最后交易日期 -> lasttradingdate
起始行权日期 -> exe_startdate
最后行权日期 -> exe_enddate
交割方式 -> settlementmethod
剩余存续期（交易日） -> ptmtradeday
剩余存续期（日历日） -> ptmday
期权衍生对应关系 -> atmiv_mapping
期权衍生剩余到期 -> atmiv_expiration

【6】市场行情
------------------------------
前收盘价 -> pre_close
交易所前收盘价 -> pre_close_exch
开盘价 -> open
最高价 -> high
最低价 -> low
收盘价 -> close
正股收盘价 -> dq_stockclose
成交量 -> volume
成交量（含大宗交易） -> volume_btin
成交额 -> amt
成交额（含大宗交易） -> amount_btin
成交笔数 -> dealnum
盘后成交量 -> volume_aht
盘后成交额 -> amount_aht
涨跌 -> chg
涨跌幅 -> pct_chg
振幅 -> swing
均价 -> vwap
复权因子 -> adjfactor
收盘价（支持定点复权） -> close2
换手率 -> turn
换手率（基准.自由流通股本） -> free_turn_n
换手率（基准.流通市值） -> dq_amtturnover
持仓量 -> oi
持仓量变化 -> oi_chg
持仓量（商品指数） -> oi_index
持仓量变化（商品指数） -> oichange
持仓额（不计保证金） -> oiamount_nomargin
持仓额 -> oiamount
前结算价 -> pre_settle
结算价 -> settle
结算价（支持复权） -> dq_settle
涨跌（收盘价） -> dq_change_close
涨跌（结算价） -> chg_settlement
涨跌幅（收盘价） -> pctchange_close
涨跌幅（结算价） -> pct_chg_settlement
最近交易日期 -> lastradeday_s
最早交易日期 -> firstradeday_s
市场最近交易日 -> last_trade_day
相对发行价涨跌 -> rel_ipo_chg
相对发行价涨跌幅 -> rel_ipo_pct_chg
交易状态 -> trade_status
总市值 -> val_mv_ARD
流通市值 -> val_mvc
连续停牌天数 -> susp_days
停牌原因 -> susp_reason
涨跌停状态 -> maxupordown
涨停价 -> maxup
跌停价 -> maxdown
贵金属现货特殊时点价 -> dq_price_premetals
升贴水 -> discount
升贴水率 -> discount__ratio
开盘价（不前推） -> open3
最高价（不前推） -> high3
最低价（不前推） -> low3
收盘价（不前推） -> close3
所属指数权重 -> indexweight
结算价（不前推） -> settle3
持仓量（不前推） -> oi3
收盘价(23：30) -> close_FX
收盘价（美元） -> close_usd
AH股溢价率 -> premiumrate_ah
交收方向（黄金现货） -> direction_gold
交收量（黄金现货） -> dquantity_gold
收盘价（夜盘） -> close_night
夜盘收盘价（支持复权） -> dq_close_night
换手率（基准.自由流通股本） -> free_turn
开盘集合竞价成交价 -> open_auction_price
开盘集合竞价成交量 -> open_auction_volume
开盘集合竞价成交额 -> open_auction_amount
周最高价 -> wq_high
周最低价 -> wq_low
周涨跌幅 -> wq_pctchange
周换手率 -> wq_turn
周成交量 -> wq_volume
周成交额 -> wq_amount
月涨跌幅 -> mq_pctchange
月换手率 -> mq_turn
月成交量 -> mq_volume
月成交额 -> mq_amount
年涨跌幅 -> yq_pctchange
年换手率 -> yq_turn
年成交量 -> yq_volume
年成交额 -> yq_amount
估值收益率（中债） -> yield_cnbd
估值净价（中债） -> net_cnbd
日间估值全价（中债） -> dirty_cnbd
估值修正久期（中债） -> modidura_cnbd
待偿年限（年）（中债） -> matu_cnbd
日间应计利息（中债） -> accruedinterest_cnbd
估值基点价值（中债） -> vobp_cnbd
估值利差久期（中债） -> sprdura_cnbd
估值利率久期（中债） -> interestduration_cnbd
点差收益率（中债） -> spreadyield_cnbd
估值凸性（中债） -> cnvxty_cnbd
估值利差凸性（中债） -> sprcnxt_cnbd
估值利率凸性（中债） -> interestcnvxty_cnbd
日终估值全价 -> price_cnbd
日终应计利息（中债） -> accrint_dayend_cnbd
加权平均结算收益率（中债） -> mcyield_cnbd
加权平均结算净价（中债） -> mcnet_cnbd
加权平均结算全价（中债） -> mdirty_cnbd
加权平均结算价修正久期（中债） -> weight_modidura
加权平均结算价利差久期（中债） -> weight_sprdura
加权平均结算价利率久期（中债） -> weight_interestduration
加权平均结算价基点价值（中债） -> weight_vobp
加权平均结算价凸性（中债） -> weight_cnvxty
加权平均结算价利差凸性（中债） -> weight_sprcnxt
加权平均结算价利率凸性（中债） -> weight_interestcnvxty
隐含评级（中债） -> rate_latestMIR_cnbd
历史隐含评级（中债） -> rate_historicalMIR_cnbd
最新估值日期（中债） -> lastdate_cnbd
估算的行权后票面利率 -> exercisecouponrate_cnbd
剩余本金（中债） -> latestpar_cnbd
期权价值（中债） -> optionval_cnbd
转股价值（中债） -> conversionval_cnbd
转股溢价率（中债） -> conversionpre_cnbd
纯债溢价率（中债） -> bondpre_cnbd
债底全价（中债） -> bonddirtyprice_cnbd
债底净价（中债） -> bondcleanprice_cnbd
债底收益率（中债） -> bondyield_cnbd
债底修正久期（中债） -> bondmodidura_cnbd
债底凸性（中债） -> bondcnvxty_cnbd
估值收益率（中证指数） -> yield_csi1
估值净价（中证指数） -> net_csi1
估值全价（中证指数） -> dirty_csi1
估值修正久期（中证指数） -> modidura_csi1
应计利息（中证指数） -> accruedinterest_csi
估值凸性（中证指数） -> cnvxty_csi1
最新估值日期（中证指数） -> lastdate_csi
隐含评级（中证指数） -> rate_latestMIR_csi
隐含违约率（中证指数） -> rate_default_csi
可交换债估值（中证指数） -> ebval_csi
可交换债期权价值（中证指数） -> eboptionval_csi
可交换债纯债溢价率（中证指数） -> ebbondpre_csi
可交换债估值收益率（中证指数） -> ebvalyield_csi
可交换债转股溢价率（中证指数） -> ebconversionpre_csi
最新估值日期（中债资信） -> lastvaluationdate_cbr
成交参考度（中债资信） -> referencelevel_cbr
日间估值全价（中债资信） -> intradayfullprice_cbr
日间应计利息（中债资信） -> intradayinterest_cbr
估值净价（中债资信） -> cleanprice_cbr
到期收益率（中债资信） -> ytm_cbr
修正久期（中债资信） -> modifiedduration_cbr
凸性（中债资信） -> convexity_cbr
ABS本金因子（中债资信） -> abs_principalbasis_cbr
ABS预计加权平均期限（中债资信） -> abs_wal_cbr
ABS累计违约率（中债资信） -> abs_cdr_cbr
ABS早偿率预测（中债资信） -> abs_prepayrate_cbr
ABS回收率预测（中债资信） -> abs_recoveryrate_cbr
前收盘价 -> preclose_b
开盘价 -> open_b
最高价 -> high_b
最低价 -> low_b
收盘价 -> originclose_b
收盘价（可转债） -> close_b
均价 -> avgprice_b
涨跌 -> change_b
涨跌幅 -> pct_chg_b
成交量 -> volume_b
成交额 -> amount_b
前收盘价（可复权） -> adjpreclose_b
开盘价（可复权） -> adjopen_b
最高价（可复权） -> adjhigh_b
最低价（可复权） -> adjlow_b
收盘价（可复权） -> adjclose_b
复权因子 -> adjfactor_b
成交量（可转债） -> volume_z_b
振幅（可转债） -> swing_b
基准债券样本券 -> rollsample
融资买入额 -> mrg_long_amt
融资偿还额 -> mrg_long_repay
融资余额 -> mrg_long_bal
融券卖出量 -> mrg_short_vol
融券偿还量 -> mrg_short_vol_repay
融券卖出额 -> margin_saletradingamount
融券偿还额 -> margin_salerepayamount
融券余量 -> mrg_short_vol_bal
融券余额 -> mrg_short_bal
融资融券余额 -> mrg_bal
融资融券担保股票市值 -> margin_guaranteedstocksmarketvalue
担保证券市值占该证券总市值比重 -> margin_marketvalueratio
转融券期末余额 -> margin_shortselleopbal
单一股票担保物比例 -> margin_sinstccolltrlratio
双边买入净价（加权平均） -> binetbid_wt
双边买入收益率（加权平均） -> bibidrt_wt
报价买入净价（算术平均） -> netbid_avg
报价买入收益率（算术平均） -> bidrt_avg
全日卖空金额 -> shortsell_Turnover
卖空金额占市场卖空总额比率 -> shortsell_TurnoverPct
全日卖空股数 -> shortsell_Volume
卖空量占成交量比率 -> shortsell_VolumePct
卖空量占香港流通股百分比 -> shortsell_VolumeToHshares
未平仓卖空数 -> share_shortshares
未平仓卖空金额 -> share_shortamount
未平仓卖空数占证券发行数量比例 -> shortsell_shortintrestpct
空头回补天数 -> shortsell_daystocover
流入额 -> mfd_buyamt_d
流出额 -> mfd_sellamt_d
流入量 -> mfd_buyvol_d
流出量 -> mfd_sellvol_d
净买入额 -> mfd_netbuyamt
净买入量 -> mfd_netbuyvol
流入单数 -> mfd_buyord
流出单数 -> mfd_sellord
主动买入额 -> mfd_buyamt_a
主动卖出额 -> mfd_sellamt_a
主动买入量 -> mfd_buyvol_a
主动卖出量 -> mfd_sellvol_a
主动买入额（全单） -> mfd_buyamt_at
主动卖出额（全单） -> mfd_sellamt_at
主动买入量（全单） -> mfd_buyvol_at
主动卖出量（全单） -> mfd_sellvol_at
净主动买入额 -> mfd_netbuyamt_a
净主动买入量 -> mfd_netbuyvol_a
净主动买入额（全单） -> mf_amt
开盘净主动买入额 -> mf_amt_open
尾盘净主动买入额 -> mf_amt_close
净主动买入率（金额） -> mf_amt_ratio
开盘净主动买入率（金额） -> mfd_inflowrate_open_a
尾盘净主动买入率（金额） -> mfd_inflowrate_close_a
净主动买入额占比 -> mfd_inflowproportion_a
开盘净主动买入额占比 -> mfd_inflowproportion_open_a
尾盘净主动买入额占比 -> mfd_inflowproportion_close_a
净主动买入量（全单） -> mf_vol
开盘资金净主动买入量 -> mfd_inflowvolume_open_a
尾盘资金净主动买入量 -> mfd_inflowvolume_close_a
净主动买入率（量） -> mfd_volinflowrate_a
开盘净主动买入率（量） -> mfd_volinflowrate_open_a
尾盘净主动买入率（量） -> mfd_volinflowrate_close_a
净主动买入量占比 -> mf_vol_ratio
开盘净主动买入量占比 -> mfd_volinflowproportion_open_a
尾盘净主动买入量占比 -> mfd_volinflowproportion_close_a
主力净流入额 -> mfd_inflow_m
开盘主力净流入额 -> mfd_inflow_open_m
尾盘主力净流入额 -> mfd_inflow_close_m
主力净流入率（金额） -> mfd_inflowrate_m
开盘主力净流入率（金额） -> mfd_inflowrate_open_m
尾盘主力净流入率（金额） -> mfd_inflowrate_close_m
主力净流入额占比 -> mfd_inflowproportion_m
开盘主力净流入额占比 -> mfd_inflowproportion_open_m
尾盘主力净流入额占比 -> mfd_inflowproportion_close_m
主力净流入量 -> mfd_buyvol_m
开盘主力净流入量 -> mfd_buyvol_open_m
尾盘主力净流入量 -> mfd_buyvol_close_m
主力净流入率（量） -> mfd_volinflowrate_m
开盘主力净流入率（量） -> mfd_volinflowrate_open_m
尾盘主力净流入率（量） -> mfd_volinflowrate_close_m
主力净流入量占比 -> mfd_volinflowproportion_m
开盘主力净流入量占比 -> mfd_volinflowproportion_open_m
尾盘主力净流入量占比 -> mfd_volinflowproportion_close_m
龙虎榜净买入额 -> abnormaltrade_netbuy
沪深港股通持续净流入天数 -> mfn_sn_inflowdays
沪深港股通持续净流出天数 -> mfn_sn_outflowdays
沪深港股通买入金额（前十名披露计算） -> mfd_sn_buyamt
沪深港股通卖出金额（前十名披露计算） -> mfd_sn_sellamt
沪深港股通净买入金额（前十名披露计算） -> mfd_sn_inflow
净流入额 -> mf_netinflow
最优报买价 -> dq_quote_bid
最优报卖价 -> dq_quote_ask
最优报中价 -> dq_quote_mid

【7】证券分析
------------------------------
总市值1 -> ev
总市值2 -> mkt_cap_ard
总市值1（币种可选） -> ev3
总市值2（币种可选） -> mkt_cap_ard2
市盈率PE(LYR,加权) -> val_pe_wgt
市盈率PE(TTM) -> pe_ttm
市盈率PE(TTM,加权) -> val_pe_ttmwgt
发布方市盈率PE(TTM) -> val_pe_ttm_issuer
市盈率PE(TTM,剔除负值) -> val_pe_nonnegative
市盈率PE(TTM,中位数) -> val_pe_median
市盈率PE(TTM,扣除非经常性损益) -> val_pe_deducted_ttm
市盈率PE(LYR) -> pe_lyr
市净率PB(MRQ) -> pb_mrq
市净率PB(LF,内地) -> pb_lf
市净率PB(MRQ,海外) -> pb_mrq_gsd
发布方市净率PB(LF) -> val_pb_If_issuer
市净率PB(LYR) -> pb_lyr
市销率PS(TTM) -> ps_ttm
市销率PS(TTM,加权) -> val_ps_ttmwgt
市销率PS(LYR) -> ps_lyr
市现率PCF(经营现金流TTM) -> pcf_ocf_ttm
市现率PCF(经营现金流TTM,加权) -> val_pcf_ocfttmwgt
市现率PCF(现金净流量TTM) -> pcf_ncf_ttm
市现率PCF(经营性净现金流LYR) -> pcf_ocflyr
市现率PCF(现金净流量LYR) -> pcf_nflyr
股息率（报告期） -> dividendyield
股息率（近12个月） -> dividendyield2
股息率TTM -> val_dividendyield3
股息率TTM(剔除特别派息) -> val_dividendyield4
发布方股息率（近12个月） -> val_dividendyield2_issuer
预测PE -> pe_est
预测PEG -> est_peg
预测PB -> estpb
企业价值（含货币资金） -> ev1
企业价值（剔除货币资金） -> ev2
企业倍数(EV/EBITDA) -> ev2_to_ebitda
企业倍数2(EV/EBITDA) -> val_evtoebitda2
总市值（不可回测） -> mkt_cap
总市值（证监会算法） -> mkt_cap_CSRC
自由流通市值 -> mkt_freeshares
流通市值（含限售股） -> mkt_cap_float
A股市值（含限售股） -> mkt_cap_ashare2
A股市值（不含限售股） -> mkt_cap_ashare
B股市值（含限售股，交易币种） -> val_bshrmarketvalue4
B股市值（含限售股，折人民币） -> val_bshrmarketvalue3
B股市值（不含限售股，交易币种） -> val_bshrmarketvalue2
B股市值（不含限售股，折人民币） -> val_bshrmarketvalue
市盈率PE -> pe
市净率PB -> pb
市销率PS -> ps
市现率PCF(现金净流量) -> pcf_ncf
市现率PCF(经营现金流) -> pcf_ocf
历史PEG -> peg
营业总收入(TTM)_PIT -> gr_ttm
营业收入(TTM)_VAL_PIT -> or_ttm
净利润(TTM)PIT -> profit_ttm
归属母公司股东的净利润(TTM)_VAL_PIT -> netprofit_ttm
扣除非经常性损益后归属母公司股东的净利润(TTM)PIT -> deductedprofit_ttm
归属母公司股东的普通股权益(LF)_PIT -> equity_new
经营活动现金净流量(TTM)PIT -> operatecashflow_ttm
现金净流量(TTM)_PIT -> cashflow_ttm
每股收益EPS(TTM)_PIT -> eps_ttm
每股经营活动产生的现金流量净额(TTM)PIT -> ocfps_ttm
每股营业收入(TTM)PIT -> orps_ttm
每股现金流量净额(TTM)_PIT -> cfps_ttm
股权激励目标净利润 -> targetnp
归属母公司股东的普通股权益(MRQ) -> equity_mrq2
ADTM动态买卖气指标 -> ADTM
ATR真实波幅 -> ATR
BBI多空指数 -> BBI
BBIBOLL多空布林线 -> BBIBOLL
BIAS乖离率 -> BIAS
BOLL布林带 -> BOLL
CCI顺势指标 -> CCI
CDP逆势操作 -> CDP
DMA平均线差 -> DMA
DMI趋向标准 -> DMI
DMI趋向指标 -> DMI_2
DPO区间震荡线 -> DPO
ENV指标 -> ENV
EXPMA指数平滑移动平均 -> EXPMA
KDJ随机指标 -> KDJ
SLOWKD慢速KD -> slowKD
MA简单移动平均 -> MA
MACD指数平滑移动平均 -> MACD
MIKE麦克指标 -> MIKE
MTM动力指标 -> MTM
PRICEOSC价格振荡指标 -> PRICEOSC
PVT量价趋势指标 -> PVT
RC变化率指数 -> RC
ROC变动速率 -> ROC
RSI相对强弱指标 -> RSI
RPS相对强度指标 -> rps
SAR抛物转向 -> SAR
SI摆动指标 -> SI
WR威廉指标 -> WR
OBV能量潮 -> OBV
SOBV能量潮 -> SOBV
SRMI MI修正指标 -> SRMI
大盘同步指标 -> PWMI
阶段强势指标 -> PRDStrong
阶段弱势指标 -> PRDWeak
筑底指标 -> BOTTOM
STD标准差 -> STD
TAPI加权指数成交值 -> TAPI
TRIX三重指数平滑平均 -> TRIX
VHF纵横指标 -> VHF
VMA量简单移动平均 -> VMA
VMACD量指数平滑异同平均 -> VMACD
VSTD成交量标准差 -> VSTD
WVAD威廉变异离散量 -> WVAD
量比 -> vol_ratio
近期创历史新高 -> history_high
近期创历史新高成交量 -> history_high_vol
近期创历史新高成交额 -> history_high_amount
近期创历史新低 -> history_low
近期创阶段新高 -> stage_high
近期创阶段新低 -> stage_low
N天M板 -> pq_maxuptype
连涨天数 -> up_days
连跌天数 -> down_days
向上有效突破均线 -> breakout_ma
向下有效突破均线 -> breakdown_ma
近期创历史新高次数 -> history_high_days
近期创历史新低次数 -> history_low_days
成份创阶段新高数量 -> techanal_stagehigh_num
成份创阶段新低数量 -> techanal_stagelow_num
均线多空头排列看涨看跌 -> bull_bear_ma
指数成份上涨数量 -> tech_upnum
指数成份下跌数量 -> tech_downnum
指数成份涨停数量 -> tech_limitupnum
指数成份跌停数量 -> tech__limitdownnum
成份分红对指数影响 -> div_compindex
平均收益率（年化，最近100周） -> annualyeild_100w
平均收益率（年化，最近24个月） -> annualyeild_24m
平均收益率（年化，最近60个月） -> annualyeild_60m
年化波动率（最近100周） -> annualstdevr_100w
年化波动率（最近24个月） -> annualstdevr_24m
年化波动率（最近60个月） -> annualstdevr_60m
BETA值（最近100周） -> beta_100w
BETA值（最近24个月） -> beta_24m
BETA值（最近60个月） -> beta_60m
风险溢价 -> risk_premium
风险溢价（倍） -> risk_premium2
剩余期限（下一行权日，天） -> day
剩余期限（下一行权日，年） -> ptmyear
特殊剩余期限（兑付日） -> termnote
特殊剩余期限（每个行权日） -> termnote1
加权剩余期限（按本息） -> weightedrt
加权剩余期限（按本金） -> weightedrt2
应计利息 -> accruedinterest
已计息天数 -> accrueddays
上一付息日 -> anal_precupn
下一付息日 -> nxcupn
距下一付息日天数 -> nxcupn2
下一付息日久期 -> nxcupn_duration
长期停牌起始日 -> pq_suspendstartdate
长期停牌截止日 -> pq_suspendenddate
收盘价（全价） -> dirtyprice
收盘价（净价） -> cleanprice
收盘到期收益率 -> ytm_b
收盘价久期 -> duration
收盘价久期（行/到） -> duration2
收盘价修正久期 -> modifiedduration
收盘价修正久期（行/到） -> modifiedduration2
收盘价凸性 -> convexity
赎回收益率 -> ytc
回售收益率 -> ytp
基准久期 -> bduration
利差久期 -> sduration
指定日现金流 -> dailycf
指定日利息现金流 -> dailycf_int
指定日本金现金流 -> dailycf_prin
指定日应计利息 -> calc_accrint
票面调整收益率 -> RCYTM
行权利差（减国开） -> optionspreadcdb
到期利差（减国开） -> maturityspreadcdb
行权利差（减国债） -> optionspreadtb
到期利差（减国债） -> maturityspreadtb
Wind主体期限结构曲线 -> maintermstructure_wind
当期收益率 -> curyield
纯债到期收益率 -> ytm_cb
纯债价值 -> strbvalue
纯债溢价 -> strbpremium
纯债溢价率 -> strbpremiumratio
转股价 -> convprice
转股比例 -> convratio
转换价值 -> convvalue
转股溢价 -> convpremium
转股溢价率 -> convpremiumratio
转股市盈率 -> convpe
转股市净率 -> convpb
正股市盈率 -> underlyingpe
正股市净率 -> underlyingpb
转股稀释率 -> diluterate
对流通股稀释率 -> ldiluterate
转债隐含波动率 -> impliedvol
双低 -> doublelow
年度可转债发行量 -> relatedcb_yearlyamount
转债发行总额 -> cb_issueamount
Wind3年评级 -> rating_wind3y
上海证券3年评级（夏普比率） -> rating_shanghaisharpe3y
期现差（股指期货） -> if_basis
期现差年化收益率（股指期货） -> anal_basisannualyield
期现差率（股指期货） -> anal_basispercent
基差（股指期货） -> anal_basis_stkidx
基差年化收益率（股指期货） -> anal_basisannualyield_stkidx
基差率（股指期货） -> anal_basispercent_stkidx
基差（商品期货） -> anal_basis
基差年化收益率（商品期货） -> basisannualyield
基差率（商品期货） -> anal_basispercent2

【8】账务数据
------------------------------
每股收益EPS-基本 -> eps_basic
每股收益EPS-稀释 -> eps_diluted
每股收益EPS-期末股本摊薄 -> eps_diluted2
每股收益EPS-最新股本摊薄 -> eps_adjust
每股收益EPS-扣除/基本 -> eps_exbasic
每股收益EPS-扣除/稀释 -> eps_exdiluted
每股收益EPS-扣除/期末股本摊薄 -> eps_exdiluted2
每股净资产BPS -> bps
每股净资产BPS(最新股本摊薄) -> bps_adjust
每股净资产BPS(最新公告) -> bps_new
每股经营活动产生的现金流量净额 -> ocfps
每股营业总收入 -> grps
每股营业收入 -> orps
每股资本公积 -> surpluscapitalps
每股盈余公积 -> surplusreserveps
每股未分配利润 -> undistributedps
每股留存收益 -> retainedps
每股现金流量净额 -> cfps
每股息税前利润 -> ebitps
每股企业自由现金流量 -> fcffps
每股股东自由现金流量 -> fcfeps
每股EBITDA -> ebitdaps
净资产收益率ROE(平均) -> roe_avg
净资产收益率ROE(加权) -> roe_basic
净资产收益率ROE(摊薄) -> roe_diluted
净资产收益率ROE(扣除/平均) -> roe_deducted
净资产收益率ROE(扣除/加权) -> roe_exbasic
净资产收益率ROE(扣除/摊薄) -> roe_exdiluted
净资产收益率ROE-增发条件 -> roe_add
总资产报酬率ROA -> roa2
总资产净利率ROA -> roa
投入资本回报率ROIC -> roic
人力投入回报率(ROP) -> ROP
净资产收益率（年化） -> roe_yearly
总资产报酬率（年化） -> roa2_yearly
总资产净利率（年化） -> roa_yearly
销售净利率 -> netprofitmargin
扣非后销售净利率 -> netprofitmargin_deducted
销售毛利率 -> grossprofitmargin
销售成本率 -> cogstosales
成本费用利润率 -> nptocostexpense
销售期间费用率 -> expensetosales
主营业务比率 -> optoebt
净利润/营业总收入 -> profittogr
营业利润/营业总收入 -> optogr
息税前利润/营业总收入 -> ebittogr
营业总成本/营业总收入 -> gctogr
销售费用/营业总收入 -> operateexpensetogr
管理费用/营业总收入 -> adminexpensetogr
财务费用/营业总收入 -> finaexpensetogr
资产减值损失/营业总收入 -> impairtogr
资产减值损失/营业利润 -> impairtoOP
EBITDA/营业总收入 -> ebitdatosales
经营活动净收益/利润总额 -> operateincometoebt
价值变动净收益/利润总额 -> investincometoebt
营业外收支净额/利润总额 -> nonoperateprofittoebt
所得税/利润总额 -> taxtoebt
扣除非经常损益后的净利润/净利润 -> deductedprofittoprofit
销售商品提供劳务收到的现金/营业收入 -> salescashintoor
经营活动产生的现金流量净额/营业收入 -> ocftoor
经营活动产生的现金流量净额/经营活动净收益 -> ocftooperateincome
净利润现金含量 -> fa_netprofitcashcover
资本支出/折旧和摊销 -> capitalizedtoda
经营活动产生的现金流量净额占比 -> ocftocf
投资活动产生的现金流量净额占比 -> icftocf
筹资活动产生的现金流量净额占比 -> fcftocf
经营活动产生的现金流量净额/营业总收入 -> ocftosales
现金满足投资比率 -> ocftoinveststockdividend
现金营运指数 -> ocftoop
全部资产现金回收率 -> ocftoassets
现金股利保障倍数 -> ocftodividend
资产负债率 -> debttoassets
剔除预收款项后的资产负债率 -> deducteddebttoassets2
剔除预收款项后的负债/总资产 -> deducteddebttoassets
长期资本负债率 -> longdebttolongcaptial
长期资产适合率 -> longcapitaltoinvestment
权益乘数 -> assetstoequity
股东权益比 -> equity_to_asset
流动资产/总资产 -> catoassets
流动负债权益比率 -> currentdebttoequity
非流动资产/总资产 -> ncatoassets
非流动负债权益比率 -> longdebttoequity
有形资产/总资产 -> tangibleassetstoassets
归属母公司股东的权益/全部投入资本 -> equitytototalcapital
带息债务/全部投入资本 -> intdebttototalcap
流动负债/负债合计 -> currentdebttodebt
非流动负债/负债合计 -> longdebtodebt
资本固定化比率 -> ncatoequity
有息负债率 -> ibdebtratio
流动比率 -> current
速动比率 -> quick
保守速动比率 -> cashratio
现金比率 -> cashtocurrentdebt
现金到期债务比 -> ocftoquickdebt
现金流量利息保障倍数 -> ocftointerest
产权比率 -> debttoequity
净资产负债率 -> fa_debttoeqy
净负债率 -> fa_netdebtratio
归属母公司股东的权益/负债合计 -> equitytodebt
归属母公司股东的权益/带息债务 -> equitytointerestdebt
有形资产/负债合计 -> tangibleassettodebt
有形资产/带息债务 -> tangassettointdebt
有形资产/净债务 -> tangibleassettonetdebt
有形净值债务率 -> debttotangibleequity
息税折旧摊销前利润/负债合计 -> ebitdatodebt
经营活动产生的现金流量净额/负债合计 -> ocftodebt
经营活动产生的现金流量净额/带息债务 -> ocftointerestdebt
经营活动产生的现金流量净额/流动负债 -> ocftoshortdebt
经营活动产生的现金流量净额/非流动负债 -> ocftolongdebt
经营活动产生的现金流量净额/净债务 -> ocftonetdebt
非筹资性现金净流量与流动负债的比率 -> ocficftocurrentdebt
非筹资性现金净流量与负债总额的比率 -> ocficftodebt
已获利息倍数(EBIT/利息费用) -> ebittointerest
长期债务与营运资金比率 -> longdebttoworkingcapital
长期负债占比 -> longdebttodebt
净债务/股权价值 -> netdebttoev
带息债务/股权价值 -> interestdebttoev
EBITDA/带息债务 -> ebitdatointerestdebt
EBITDA/利息费用 -> ebitdatointerest
全部债务/EBITDA -> tltoebitda
货币资金/短期债务 -> cashtostdebt
现金短债比 -> fa_stdebtratio
长期债务资本化比率 -> fa_crofll
营业周期 -> turndays
存货周转天数 -> invturndays
应收账款周转天数 -> arturndays
应付账款周转天数 -> apturndays
净营业周期 -> netturndays
存货周转率 -> invturn
应收账款周转率 -> arturn
应收账款及应收票据周转率 -> fa_arnrturn
流动资产周转率 -> caturn
营运资本周转率 -> operatecaptialturn
固定资产周转率 -> faturn
非流动资产周转率 -> non_currentassetsturn
总资产周转率 -> assetsturn1
总资产周转率(TTM) -> turnover_ttm
应付账款周转率 -> apturn
应付账款及应付票据周转率 -> fa_apnpturn
应收账款周转率（含坏账准备） -> fa_arturn_reserve
现金周转率 -> fa_cashturnratio
基本每股收益（同比增长率） -> yoyeps_basic
稀释每股收益（同比增长率） -> yoyeps_diluted
每股经营活动产生的现金流量净额（同比增长率） -> yoyocfps
营业总收入（同比增长率） -> yoy_tr
营业收入（同比增长率） -> yoy_or
营业利润（同比增长率） -> yoyop
营业利润（同比增长率）2 -> yoyop2
利润总额（同比增长率） -> yoyebt
净利润（同比增长率） -> yoyprofit
归属母公司股东的净利润（同比增长率） -> yoynetprofit
扣除非经常性损益后的净利润（同比增长率） -> dp_yoy
经营活动产生的现金流量净额（同比增长率） -> yoyocf
筹资活动产生的现金流量净额（同比增长率） -> yoyfcf
净资产收益率（摊薄）（同比增长） -> yoyroe
资本项目规模维持率 -> maintenance
货币资金增长率 -> yoy_cash
固定资产投资扩张率 -> yoy_fixedassets
研发费用同比增长 -> fa_rdexp_yoy
净资产（同比增长率） -> yoy_equity
现金净流量（同比增长率） -> yoycf
总负债（同比增长率） -> yoydebt
总资产（同比增长率） -> yoy_assets
每股净资产（相对年初增长率） -> yoybps
资产总计（相对年初增长率） -> yoyassets
归属母公司股东的权益（相对年初增长率） -> yoyequity
净资产收益率ROE -> roe
权益乘数（杜邦分析） -> dupont_assetstoequity
归属母公司股东的净利润/净利润 -> dupont_np
总资产周转率 -> assetsturn
净利润/利润总额 -> dupont_taxburden
利润总额/息税前利润 -> dupont_intburden
净资产收益率(TTM) -> roe_ttm2
净资产收益率(TTM,平均) -> fa_roe_ttmavg
总资产报酬率(TTM) -> roa2_ttm2
投入资本回报率(TTM) -> roic2_ttm
总资产净利率-不含少数股东损益(TTM) -> netprofittoassets
投入资本回报率ROIC(TTM) -> roic_ttm2
息税前利润(TTM)/总资产 -> ebittoassets2
销售净利率(TTM) -> netprofitmargin_ttm2
销售毛利率(TTM) -> grossprofitmargin_ttm2
销售期间费用率(TTM) -> expensetosales_ttm2
净利润/营业总收入(TTM) -> profittogr_ttm2
营业利润/营业总收入(TTM) -> optogr_ttm2
营业总成本/营业总收入(TTM) -> gctogr_ttm2
营业利润/营业收入(TTM) -> optoor_ttm
归属母公司股东的净利润/营业收入(TTM) -> netprofittoor_ttm
销售费用/营业总收入(TTM) -> operateexpensetogr_ttm2
管理费用/营业总收入(TTM) -> adminexpensetogr_ttm2
财务费用/营业总收入(TTM) -> finaexpensetogr_ttm2
税项/利润总额(TTM) -> taxtoebt_ttm
资产减值损失/营业总收入(TTM) -> impairtogr_ttm2
经营活动净收益/利润总额(TTM) -> operateincometoebt_ttm2
价值变动净收益/利润总额(TTM) -> investincometoebt_ttm2
营业外收支净额/利润总额(TTM) -> nonoperateprofittoebt_ttm2
营业利润/利润总额(TTM) -> taxtoor_ttm
利润总额/营业收入(TTM) -> ebttoor_ttm
销售商品提供劳务收到的现金/营业收入(TTM) -> salescashintoor_ttm2
经营活动产生的现金流量净额/营业收入(TTM) -> ocftoor_ttm2
经营活动产生的现金流量净额/经营活动净收益(TTM) -> ocftooperateincome_ttm2
经营活动产生的现金流量净额/营业利润(TTM) -> operatecashflowtoop_ttm
营业总收入(TTM) -> gr_ttm2
营业总成本(TTM) -> gc_ttm2
营业总成本2(TTM) -> gc2_ttm2
营业收入(TTM) -> or_ttm2
营业成本-非金融类(TTM) -> cost_ttm2
营业支出-金融类(TTM) -> expense_ttm2
毛利(TTM) -> grossmargin_ttm2
销售费用(TTM) -> operateexpense_ttm2
管理费用(TTM) -> adminexpense_ttm2
财务费用(TTM) -> finaexpense_ttm2
期间费用(TTM) -> periodexpense_t_ttm
利息费用(TTM) -> interestexpense_ttm
少数股东损益(TTM) -> minorityinterest_ttm
资产减值损失(TTM) -> impairment_ttm2
经营活动净收益(TTM) -> operateincome_ttm2
价值变动净收益(TTM) -> investincome_ttm2
营业利润(TTM) -> op_ttm2
营业外收支净额(TTM) -> nonoperateprofit_ttm2
息税前利润(TTM反推法) -> ebit_ttm2
所得税(TTM) -> tax_ttm
利润总额(TTM) -> ebt_ttm2
净利润(TTM) -> profit_ttm2
归属母公司股东的净利润(TTM) -> netprofit_ttm2
扣除非经常性损益后归属母公司股东的净利润(TTM) -> deductedprofit_ttm2
EBITDA(TTM反推法) -> ebitda_ttm
销售商品提供劳务收到的现金(TTM) -> salescashin_ttm2
经营活动现金净流量(TTM) -> operatecashflow_ttm2
投资活动现金净流量(TTM) -> investcashflow_ttm2
筹资活动现金净流量(TTM) -> financecashflow_ttm2
现金净流量(TTM) -> cashflow_ttm2
扣非后每股收益(TTM) -> eps_deducted_ttm

【9】财务报表
------------------------------
货币资金 -> monetary_cap
以公允价值计量且其变动计入当期损益的金融资产 -> tradable_fin_assets
受限资产 -> stm_ra
受限资金 -> fund_restricted
应收票据 -> notes_rcv
应收账款 -> acct_rcv
应收款项融资 -> financing_a/r
预付款项 -> prepay
其他应收款（合计） -> oth_rcv_tot
应收股利 -> dvd_rcv
应收利息 -> int_rcv
其他应收款 -> oth_rcv
存货 -> inventories
消耗性生物资产 -> consumptive_bio_assets
合同资产 -> cont_assets
待摊费用 -> deferred_exp
划分为持有待售的资产 -> hfs_assets
一年内到期的非流动资产 -> non_cur_assets_due_within_1y
结算备付金 -> settle_rsrv
拆出资金 -> loans_to_oth_banks
融出资金 -> margin_acct
应收保费 -> prem_rcv
应收分保账款 -> rcv_from_reinsurer
应收分保合同准备金 -> rcv_from_ceded_insur_cont_rsrv
买入返售金融资产 -> red_monetary_cap_for_sale
应收款项 -> tot_acct_rcv
其他流动资产 -> oth_cur_assets
流动资产差额（特殊报表科目） -> cur_assets_gap
流动资产差额说明（特殊报表科目） -> cur_assets_gap_detail
流动资产差额（合计平衡项目） -> cur_assets_netting
流动资产合计 -> tot_cur_assets
金融投资 -> fin_invest
以公允价值计量且其变动计入其他综合收益的金.. -> fin_assets_chg_compreh_inc
以摊余成本计量的金融资产 -> fin_assets_amortizedcost
债权投资 -> debt_invest
其他债权投资 -> oth_debt_invest
可供出售金融资产 -> fin_assets_avail_for_sale
其他权益工具投资 -> oth_eqy_instruments_invest
持有至到期投资 -> held_to_mty_invest
其他非流动金融资产 -> oth_non_cur_fina_asset
投资性房地产 -> invest_real_estate
长期股权投资 -> long_term_eqy_invest
长期应收款 -> long_term_rec
固定资产（合计） -> fix_assets_tot
固定资产 -> fix_assets
固定资产清理 -> fix_assets_disp
在建工程（合计） -> const_in_prog_tot
在建工程 -> const_in_prog
工程物资 -> proj_matl
生产性生物资产 -> productive_bio_assets
油气资产 -> oil_and_natural_gas_assets
使用权资产 -> prop_right_use
无形资产 -> intang_assets
开发支出 -> r_and_d_costs
商誉 -> goodwill
长期待摊费用 -> long_term_deferred_exp
递延所得税资产 -> deferred_tax_assets
发放贷款及垫款 -> loans_and_adv_granted
其他非流动资产 -> oth_non_cur_assets
非流动资产差额（特殊报表科目） -> non_cur_assets_gap
非流动资产差额说明（特殊报表科目） -> non_cur_assets_gap_detail
非流动资产差额（合计平衡项目） -> non_cur_assets_netting
非流动资产合计 -> tot_non_cur_assets
现金及存放中央银行款项 -> cash_deposits_central_bank
代理业务资产 -> agency_bus_assets
应收款项类投资 -> rcv_invest
存放同业和其它金融机构款项 -> asset_dep_oth_banks_fin_inst
贵金属 -> precious_metals
应收分保未到期责任准备金 -> rcv_ceded_unearned_prem_rsrv
应收分保未决赔款准备金 -> rcv_ceded_claim_rsrv
应收分保寿险责任准备金 -> rcv_ceded_life_insur_rsrv
应收分保长期健康险责任准备金 -> rcv_ceded_lt_health_insur_rsrv
保户质押贷款 -> insured_pledge_loan
存出资本保证金 -> cap_mrgn_paid
独立账户资产 -> independent_acct_assets
定期存款 -> time_deposits
应收代位追偿款 -> subr_rec
存出保证金 -> mrgn_paid
交易席位费 -> seat_fees_exchange
客户资金存款 -> clients_cap_deposit
客户备付金 -> clients_rsrv_settle
其他资产 -> oth_assets
衍生金融资产 -> derivative_fin_assets
资产差额（特殊报表科目） -> assets_gap
资产差额说明（特殊报表科目） -> assets_gap_detail
资产差额（合计平衡项目） -> assets_netting
资产总计 -> tot_assets
短期借款 -> st_borrow
以公允价值计量且其变动计入当期损益的金融负债 -> tradable_fin_liab
应付票据及应付账款 -> acctandnotes_payable
应付票据 -> notes_payable
应付账款 -> acct_payable
预收账款 -> adv_from_cust
合同负债 -> cont_liab
应付职工薪酬 -> empl_ben_payable
应交税费 -> taxes_surcharges_payable
应付款项 -> tot_acct_payable
其他应付款（合计） -> oth_payable_tot
应付利息 -> int_payable
应付股利 -> dvd_payable
其他应付款 -> oth_payable
预提费用 -> acc_exp
递延收益-流动负债 -> deferred_inc_cur_liab
划分为持有待售的负债 -> hfs_liab
一年内到期的非流动负债 -> non_cur_liab_due_within_1y
应付短期债券 -> st_bonds_payable
吸收存款及同业存放 -> deposit_received_ib_deposits
向中央银行借款 -> borrow_central_bank
拆入资金 -> loans_oth_banks
卖出回购金融资产款 -> fund_sales_fin_assets_rp
应付手续费及佣金 -> handling_charges_comm_payable
应付分保账款 -> payable_to_reinsurer
保险合同准备金 -> rsrv_insur_cont
代理买卖证券款 -> acting_trading_sec
代理承销证券款 -> acting_uw_sec
其他流动负债 -> oth_cur_liab
流动负债差额（特殊报表科目） -> cur_liab_gap
流动负债差额说明（特殊报表科目） -> cur_liab_gap_detail
流动负债差额（合计平衡项目） -> cur_liab_netting
流动负债合计 -> tot_cur_liab
长期借款 -> It_borrow
应付债券 -> bonds_payable
租赁负债 -> lease_obligation
长期应付款（合计） -> It_payable_tot
长期应付款 -> It_payable
长期应付职工薪酬 -> It_empl_ben_payable
专项应付款 -> specific_item_payable
预计负债 -> provisions
递延所得税负债 -> deferred_tax_liab
递延收益-非流动负债 -> deferred_inc_non_cur_liab
其他非流动负债 -> oth_non_cur_liab
非流动负债差额（特殊报表科目） -> non_cur_liab_gap
非流动负债差额说明（特殊报表科目） -> non_cur_liab_gap_detail
非流动负债差额（合计平衡项目） -> non_cur_liab_netting
非流动负债合计 -> tot_non_cur_liab
同业和其它金融机构存放款项 -> liab_dep_oth_banks_fin_inst
代理业务负债 -> agency_bus_liab
吸收存款 -> cust_bank_dep
应付赔付款 -> claims_payable
应付保单红利 -> dvd_payable_insured
存入保证金 -> deposit_received
保户储金及投资款 -> insured_deposit_invest
未到期责任准备金 -> unearned_prem_rsrv
未决赔款准备金 -> out_loss_rsrv
寿险责任准备金 -> life_insur_rsrv
长期健康险责任准备金 -> It_health_insur_v
独立账户负债 -> independent_acct_liab
预收保费 -> prem_received_adv
质押借款 -> pledge_loan
应付短期融资款 -> st_finl_inst_payable
其他负债 -> oth_liab
衍生金融负债 -> derivative_fin_liab
负债差额（特殊报表科目） -> liab_gap
负债差额说明（特殊报表科目） -> liab_gap_detail
负债差额（合计平衡项目） -> liab_netting
负债合计 -> tot_liab
实收资本（或股本） -> cap_stk
其他权益工具 -> other_equity_instruments
其他权益工具：优先股 -> other_equity_instruments_PRE
其他权益工具：永续债 -> perpetual_debt
资本公积金 -> cap_rsrv
盈余公积金 -> surplus_rsrv
未分配利润 -> undistributed_profit
库存股 -> tsy_stk
其他综合收益BS -> other_compreh_inc_bs
专项储备 -> special_rsrv
一般风险准备 -> prov_nom_risks
外币报表折算差额 -> cnvd_diff_foreign_curr_stat
未确认的投资损失BS -> unconfirmed_invest_loss_bs
股东权益差额（特殊报表科目） -> shrhldr_eqy_gap
其他股东权益差额说明（特殊报表科目） -> shrhldr_eqy_gap_detail
股东权益差额（合计平衡项目） -> shrhldr_eqy_netting
归属母公司股东的权益 -> eqy_belongto_parcomsh
少数股东权益 -> minority_int
所有者权益合计 -> tot_equity
负债及股东权益差额（特殊报表科目） -> liab_shrhldr_eqy_gap
负债及股东权益差额说明（特殊报表科目） -> liab_shrhldr_eqy_gap_detail
负债及股东权益差额（合计平衡项目） -> liab_shrhldr_eqy_netting
负债及股东权益总计 -> tot_liab_shrhldr_eqy
营业总收入 -> tot_oper_rev
营业收入 -> oper_rev
利息收入 -> int_inc
已赚保费 -> insur__prem_unearned
手续费及佣金收入 -> handling_chrg_comm_inc
保费业务收入 -> tot_prem_inc
分保费收入 -> reinsur_inc
分出保费 -> prem_ceded
提取未到期责任准备金 -> unearned_prem_rsrv_withdraw
代理买卖证券业务净收入 -> net_inc_agencybusiness
证券承销业务净收入 -> net_inc_underwriting-business
受托客户资产管理业务净收入 -> net_inc_customerasset-managementbusiness
其他业务收入 -> other_oper_inc
利息净收入 -> net_int_inc
手续费及佣金净收入 -> net_fee_and_commission_inc
其他业务净收益 -> net_other_oper_inc
营业总成本 -> tot_oper_cost
营业总成本2 -> operating_cost2
营业成本 -> oper_cost
利息支出 -> int_exp
手续费及佣金支出 -> handling_chrg_comm_exp
营业支出 -> oper_exp
税金及附加 -> taxes_surcharges_ops
销售费用 -> selling_dist_exp
管理费用 -> gerl_admin_exp
研发费用 -> rd_exp
财务费用 -> fin_exp_is
财务费用：利息费用 -> fin_int_exp
财务费用：利息收入 -> fin_int_inc
其他资产减值损失 -> other_assets_impair_loss
资产减值损失 -> impair_loss_assets
信用减值损失 -> credit_impair_loss
退保金 -> prepay_surr
赔付支出净额 -> net_claim_exp
提取保险责任准备金 -> net_insur_cont_rsrv
保单红利支出 -> dvd_exp_insured
分保费用 -> reinsurance_exp
摊回赔付支出 -> claim_exp_recoverable
摊回保险责任准备金 -> Insur_rsrv_recoverable
摊回分保费用 -> reinsur_exp_recoverable
其他业务成本 -> other_oper_exp
某他经营净收益 -> net_inc_other_ops
分允价值变动净收益 -> net_gain_chg_fv
摊资净收益 -> net_invest_inc
摊联营企业和合营企业的投资收益 -> inc_invest_assoc_jv_entp
摊摊余成本计量的金融资产终止确认收益 -> ter_fin_ass_income
其敞口套期收益 -> net_exposure_hedge_ben
兑净收益 -> net_gain_fx_trans
资产处置收益 -> gain_asset_dispositions
其他收益 -> other_grants_inc
营业利润差额（特殊报表科目） -> opprofit_gap
营业利润差额说明（特殊报表科目） -> opprofit_gap_detail
营业利润差额（合计平衡项目） -> opprofit_netting
营业利润 -> opprofit
营业外收入 -> non_oper_rev
营业外支出 -> non_oper_exp
非流动资产处置净损失 -> net_loss_disp_noncur_asset
利润总额差额（特殊报表科目） -> profit_gap
利润总额差额说明（特殊报表科目） -> profit_gap_detail
利润总额差额（合计平衡项目） -> profit_netting
利润总额 -> tot_profit
所得税 -> tax
未确认的投资损失 -> unconfirmed_invest_loss_is
净利润差额（特殊报表科目） -> net_profit_is_gap
净利润差额说明（特殊报表科目） -> net_profit_is_gap_detail
净利润差额（合计平衡项目） -> net_profit_is_netting
净利润 -> net_profit_is
持续经营净利润 -> net_profit_continued
终止经营净利润 -> net_profit_discontinued
少数股东损益 -> minority_int_inc
归属母公司股东的净利润 -> np_belongto_parcomsh
基本每股收益 -> eps_basic_is
稀释每股收益 -> eps_diluted_is
其他综合收益 -> other_compreh_inc
综合收益总额 -> tot_compreh_inc
归属于少数股东的综合收益总额 -> tot_compreh_inc_min_shrhldr
归属于母公司普通股东综合收益总额 -> tot_compreh_inc_parent_comp

【10】财务报表
------------------------------
销售商品、提供劳务收到的现金 -> cash_recp_sg_and_rs
收到的税费返还 -> recp_tax_rends
收到其他与经营活动有关的现金 -> other_cash_recp_ral_oper_act
保户储金净增加额 -> net_incr_insured_dep
客户存款和同业存放款项净增加额 -> net_incr_dep_cob
向中央银行借款净增加额 -> net_incr_loans_central_bank
向其他金融机构拆入资金净增加额 -> net_incr_fund_borr_ofi
收取利息和手续费净增加额 -> net_incr_int_handling_chrg
收到原保险合同保费取得的现金 -> cash_recp_prem_orig_inco
收到再保业务现金净额 -> net_cash_received_reinsu_bus
处置交易性金融资产净增加额 -> net_incr_disp_tfa
处置可供出售金融资产净增加额 -> net_incr_disp_fin_assets_avail
拆入资金净增加额 -> net_incr_loans_other_bank
拆入/拆出资金净减少额 -> net_decr_loans_other_bank
回购业务资金净增加额 -> net_incr_repurch_bus_fund
代理买卖证券收到的现金净额 -> net_cash_from_seurities
经营活动现金流入差额（特殊报表科目） -> cash_inflows_oper_act_gap
经营活动现金流入差额说明（特殊报表科目） -> cash_inflows_oper_act_gap_detail
经营活动现金流入差额（合计平衡项目） -> cash_inflows_oper_act_netting
经营活动现金流入小计 -> stot_cash_inflows_oper_act
融出资金净增加额 -> net_incr_lending_fund
以公允价值计量且其变动计入当期损益的. -> net_fina_instruments_measured_at_fmv
购买商品、接受劳务支付的现金 -> cash_pay_goods_purch_serv_rec
支付给职工以及为职工支付的现金 -> cash_pay_beh_empl
支付的各项税费 -> pay_all_typ_tax
支付其他与经营活动有关的现金 -> other_cash_pay_ral_oper_act
客户贷款及垫款净增加额 -> net_incr_clients_loan_adv
存放央行和同业款项净增加额 -> net_incr_dep_cbob
支付原保险合同赔付款项的现金 -> cash_pay_claims_orig_inco
支付手续费的现金 -> handling_chrg_paid
支付保单红利的现金 -> comm_insur_plcy_paid
经营活动现金流出差额（特殊报表科目） -> cash_outflows_oper_act_gap
经营活动现金流出差额说明（特殊报表科目） -> cash_outflows_oper_act_gap_detail
经营活动现金流出差额（合计平衡项目） -> cash_outflows_oper_act_netting
经营活动现金流出小计 -> stot_cash_outflows_oper_act
经营活动产生的现金流量净额差额（合计平.. -> cf_oper_act_netting
经营活动产生的现金流量净额 -> net_cash_flows_oper_act
收回投资收到的现金 -> cash_recp_disp_withdrwl_invest
取得投资收益收到的现金 -> cash_recp_return_invest
处置固定资产、无形资产和其他长期资产.. -> net_cash_recp_disp_fiolta
处置子公司及其他营业单位收到的现金净额 -> net_cash_recp_disp_sobu
收到其他与投资活动有关的现金 -> other_cash_recp_ral_inv_act
投资活动现金流入差额（特殊报表科目） -> cash_inflows_inv_act_gap
投资活动现金流入差额说明（特殊报表科目） -> cash_inflows_inv_act_gap_detail
投资活动现金流入差额（合计平衡项目） -> cash_inflows_inv_act_netting
投资活动现金流入小计 -> stot_cash_inflows_inv_act
购建固定资产、无形资产和其他长期资产.. -> cash_pay_acq_const_fiolta
投资支付的现金 -> cash_paid_invest
质押贷款净增加额 -> net_incr_pledge_loan
取得子公司及其他营业单位支付的现金净额 -> net_cash_pay_aquis_sobu
支付其他与投资活动有关的现金 -> other_cash_pay_ral_inv_act
投资活动现金流出差额（特殊报表科目） -> cash_outflows_inv_act_gap
投资活动现金流出差额说明（特殊报表科目） -> cash_outflows_inv_act_gap_detail
投资活动现金流出差额（合计平衡项目） -> cash_outflows_inv_act_netting
投资活动现金流出小计 -> stot_cash_outflows_inv_act
投资活动产生的现金流量净额差额（合计平.. -> cf_inv_act_netting
投资活动产生的现金流量净额 -> net_cash_flows_inv_act
吸收投资收到的现金 -> cash_recp_cap_contrib
子公司吸收少数股东投资收到的现金 -> cash_rec_saims
取得借款收到的现金 -> cash_recp_borrow
收到其他与筹资活动有关的现金 -> other_cash_recp_ral_fnc_act
发行债券收到的现金 -> proc_issue_bonds
筹资活动现金流入差额（特殊报表科目） -> cash_inflows_fnc_act_gap
筹资活动现金流入差额说明（特殊报表科目） -> cash_inflows_fnc_act_gap_detail
筹资活动现金流入差额（合计平衡项目） -> cash_inflows_fnc_act_netting
筹资活动现金流入小计 -> stot_cash_inflows_fnc_act
偿还债务支付的现金 -> cash_prepay_amt_borr
分配股利、利润或偿付利息支付的现金 -> cash_pay_dist_dpcp_int_exp
子公司支付给少数股东的股利、利润 -> dvd_profit_paid_sc_ms
支付其他与筹资活动有关的现金 -> other_cash_pay_ral_fnc_act
筹资活动现金流出差额（特殊报表科目） -> cash_outflows_fnc_act_gap
筹资活动现金流出差额说明（特殊报表科目） -> cash_outflows_fnc_act_gap_detail
筹资活动现金流出差额（合计平衡项目） -> cash_outflows_fnc_act_netting
筹资活动现金流出小计 -> stot_cash_outflows_fnc_act
筹资活动产生的现金流量净额差额（合计平.. -> cf_fnc_act_netting
筹资活动产生的现金流量净额 -> net_cash_flows_fnc_act
汇率变动对现金的影响 -> eff_fx_flu_cash
现金及现金等价物净增加额差额（特殊报表.. -> net_incr_cash_cash_equ_gap
现金及现金等价物净增加额差额说明（特殊.. -> net_incr_cash_cash_equ_gap_detail
现金及现金等价物净增加额差额（合计平衡.. -> net_incr_cash_cash_equ_netting
现金及现金等价物净增加额 -> net_incr_cash_cash_equ_dm
期初现金及现金等价物余额 -> cash_cash_equ_beg_period
期末现金及现金等价物余额 -> cash_cash_equ_end_period
净利润_CS -> net_profit_cs
资产减值准备 -> prov_depr_assets
信用减值损失 -> credit_impair_loss2
固定资产折旧、油气资产折耗、生产性生.. -> depr_fa_coga_dpba
无形资产摊销 -> amort_intang_assets
使用权资产折旧 -> depre_prop_right_use
长期待摊费用摊销 -> amort_It_deferred_exp
待摊费用减少 -> decr_deferred_exp
预提费用增加 -> incr_acc_exp
处置固定资产、无形资产和其他长期资产.. -> loss_disp_fiolta
固定资产报废损失 -> loss_scr_fa
公允价值变动损失 -> loss_fv_chg
财务费用_CS -> fin_exp_cs
投资损失 -> invest_loss
递延所得税资产减少 -> decr_deferred_inc_tax_assets
递延所得税负债增加 -> incr_deferred_inc_tax_liab
存货的减少 -> decr_inventories
经营性应收项目的减少 -> decr_oper_payable
经营性应付项目的增加 -> incr_oper_payable
未确认的投资损失_CS -> unconfirmed__invest_loss_cs
间接法-经营活动现金流量净额差额（特殊.. -> im_net_cash_flows_oper_act_gap
其他 -> others
间接法-经营活动现金流量净额差额说明(.. -> im_net__cash_flows__oper__act_gap_detail
间接法-经营活动现金流量净额差额（合计.. -> im_net_cash_flows_oper_act_netting
间接法-经营活动产生的现金流量净额 -> im_net_cash_flows_oper_act
债务转为资本 -> conv_debt_into_cap
年内到期的可转换公司债券 -> conv_corp_bonds_due_within_1y
融资租入固定资产 -> fa_fnc_leases
现金的期末余额 -> end_bal_cash
现金的期初余额 -> beg_bal_cash
现金等价物的期末余额 -> end_bal_cash_equ
现金等价物的期初余额 -> beg_bal_cash_equ
间接法-现金净增加额差额（特殊报表科目） -> im_net_incr_cash_cash_equ_gap
间接法-现金净增加额差额说明（特殊报表.. -> im_net_incr_cash_cash_equ_gap_detail
间接法-现金净增加额差额（合计平衡项目） -> im_net_incr_cash_cash_equ_netting
间接法-现金及现金等价物净增加额 -> net_incr_cash_cash_equ_im

【11】权益事件
------------------------------
每股股利（税前）（已宣告） -> div_cashbeforetax2
每股股利（税后）（已宣告） -> div_cashaftertax2
每股红股（已宣告） -> div_stock2
每股转增股本（已宣告） -> div_capitalization2
每股转增股本 -> div_capitalization
每股红股 -> div_stock
每股股利（税后） -> div_cashaftertax
每股股利（税前） -> div_cashbeforetax
每股股利（税前）（币种可选） -> div_cashbftax
每股股利（税前，剔除特别派息） -> div_cashbftax_ex
每股分红送转 -> div_cashandstock
分红方案进度 -> div_progress
分红对象 -> div_object
是否分红 -> div_ifdiv
分红基准股本 -> div_shares
年度现金分红比例（公告） -> div_dividendratio
年度现金分红总额（公告） -> div_aualcashdividend
股权登记日 -> div_recorddate
除权除息日 -> div_exdate
派息日 -> div_paydate
红股上市交易日 -> div_trddateshareb
预披露公告日 -> div_preDisclosureDate
预案公告日 -> div_prelandate
股东大会公告日 -> div_smtgdate
分红实施公告日 -> div_impdate
B股最后交易日 -> div_lasttrddateshareb
B股股权登记日 -> div_recdateshareb
现金分红首次披露日 -> div_fstdiscdate
年度现金分红次数 -> div_freq
年度累计单位分红 -> div_aualaccmdivpershare
年度累计分红总额（已宣告） -> div_aualaccmdiv3
年度累计分红总额（已宣告，剔除特别派息） -> div_aualaccmdiv_ex
年度现金分红比例（已宣告） -> div_payoutRatio2
年度现金分红比例（已宣告，剔除特别派息） -> div_payoutRatio_ex
三年累计分红占比 -> div_divpct_3yearaccu
上市以来分红率 -> div_divpct_accu
首发上市日期 -> ipo_date
首发价格 -> ipo_price2
发行前均价 -> ipo_preprice
发行数量合计 -> ipo_amount
新股发行数量 -> ipo_newshares
新股初始发行数量 -> ipo_newshares_initial
股东售股数量 -> ipo_oldshares
老股转让比例 -> ipo_oldsharesratio
募集资金总额（含股东售股） -> ipo_collection_total
首发募集资金 -> ipo_collection
股东售股金额 -> ipo_collection_oldshares2
首发募集资金净额 -> ipo_netcollection_ture
首发预计募集资金 -> ipo_expectedcollection2
发行时每股面值 -> ipo_par
首发后总股本（上市日） -> ipo_totcapafterissue
网上发行数量（回拨前） -> ipo_poc_online
网下发行数量（回拨前） -> ipo_poc_offline
网上发行数量 -> ipo_cashamt
网下发行数量 -> ipo_amttojur
网上发行有效申购数量 -> ipo_VSShares_s
网上发行有效认购倍数 -> ipo_subratio
网下发行有效申购数量 -> ipo_intvsshares
网下发行有效申购倍数 -> ipo_intsubratio
申报预披露日 -> ipo_WpipReleasingdate
IPO申报预披露更新日 -> wpipReleasingdateup
招股公告日 -> ipo_puboffrdate
聆讯后资料公告日 -> ipo_posthearing
发行公告日 -> ipo_anncedate
发行结果公告日 -> ipo_resultdate
首发发行费用 -> ipo_expense2
首发主承销商 -> ipo_leadundr
首发保荐机构 -> ipo_sponsor
首发副主承销商 -> ipo_deputyundr
首发保荐人律师 -> ipo_legaladvisor
首发稳价人 -> ipo_StabilizingManager
首发发行方式 -> ipo_type
首发承销保荐费用 -> ipo_usfees2
新股配售经纪佣金费率 -> ipo_commissionrate
首发审计费用 -> ipo_auditfee
首发信息披露费 -> ipo_idc
首发法律费用 -> ipo_lawfee
是否行使超额配售权 -> ipo_greenshoe
是否触发回拨机制 -> ipo_backmechanism
计划发行总数 -> ipo_issuvolplanned
申购一手中签率 -> ipo_dtooratio_pl
稳购1手最低申购股数 -> ipo_minsubscription_pl
超额配售数量 -> ipo_overallot_vol
公开发售甲组申购人数 -> ipo_subnum_a
公开发售乙组申购人数 -> ipo_subnum_b
公开发售申购人数 -> ipo_subnum
首日上市数量 -> ipo_lstnum
上市首日开盘价 -> ipo_open
上市首日最高价 -> ipo_high
上市首日最低价 -> ipo_low
上市首日收盘价 -> ipo_close
上市首日成交均价 -> ipo_avgprice
上市首日成交量 -> ipo_listdayvolume
上市首日成交额 -> ipo_volume
上市首日涨跌幅 -> ipo_pctchange
上市首日换手率 -> ipo_turn
上市后N日涨跌幅 -> ipo_npctchange
上市后N日换手率 -> ipo_nturn
上市天数 -> ipo_listdays
上市交易天数 -> ipo_tradedays
新股未开板涨停板天数 -> ipo_limitupdays
开板日 -> ipo_limitupopendate
新股开板日收盘价 -> ipo_limitupopendate_close
新股开板日成交均价 -> ipo_limitupopendate_avgprice
新股开板日涨跌幅 -> ipo_limitupopendate_pctchange

【12】投资组合（资产配置）
------------------------------
未上市流通基金份数（封闭式） -> unit_nontradable
已上市流通基金份数（封闭式） -> unit_tradable
基金份额变动日期 -> unit_changedate
分级基金规模（公告披露，最新） -> fund_fundscale
基金规模合计（公告披露） -> netasset_total
基金规模合计（公告披露，币种转换） -> netasset_total_co
基金资产总值 -> prt_totalasset
分级基金规模（报告期） -> prt_netasset
上市基金规模(Wind计算) -> etf_netasset
报告期基金规模币种 -> prt_currency
报告期基金日均规模 -> prt_avgnetasset
基金规模合计（报告期） -> prt_fundnetasset_total
资产净值是否为合并数据（最新） -> prt_mergednavornot
基金规模是否为合并数据 -> prt_mergednavornot1
基金净值占基金资产总值比 -> prt_navtoasset
同类基金平均规模 -> fund_avgfundscale
规模同类排名 -> fund_scaleranking
基金规模变动 -> prt_netassetchange
基金规模变动率 -> prt_netassetchangeratio
基金资产总值变动 -> prt_totalassetchange
基金资产总值变动率 -> prt_totalassetchangeratio
股票投资市值 -> prt_stockvalue
指数投资股票市值 -> prt_stockvalue_passiveinvest
积极投资股票市值 -> prt_stockvalue_activeinvest
港股投资市值 -> prt_hkstockvalue
国家/地区投资市值(QDII) -> prt_qdii_countryregioninvestment
债券投资市值 -> prt_bondvalue
股指期货投资市值 -> prt_Slfutures
国债期货投资市值 -> prt_gbfutures
权证投资市值 -> prt_warrantvalue
转融通证券出借业务市值 -> prt_seclendingvalue
买入返售金融资产 -> prt_reverserepo
银行存款 -> prt_cash
国家/地区投资市值占基金资产净值比例(QDII) -> prt_qdii_countryregioninvestmenttonav
港股投资市值占基金资产净值比 -> prt_hkstocktonav
指数投资股票市值占基金资产净值比 -> prt_stocktonav_passiveinvest
积极投资股票市值占基金资产净值比 -> prt_stocktonav_activeinvest
债券市值占基金资产净值比 -> prt_bondtonav
基金市值占基金资产净值比 -> prt_fundtonav
权证市值占基金资产净值比 -> prt_warranttonav
银行存款占基金资产净值比 -> prt_cashtonav
其他资产占基金资产净值比 -> prt_othertonav
买入返售证券占基金资产净值比例 -> prt_reverserepotonav
转融通证券出借业务市值占基金资产净值比 -> prt_seclendingvaluetonav
股票市值占基金资产总值比 -> prt_stocktoasset
港股投资市值占基金资产总值比 -> prt_hkstocktoasset
债券市值占基金资产总值比 -> prt_bondtoasset
基金市值占基金资产总值比 -> prt_fundtoasset
权证市值占基金资产总值比 -> prt_warranttoasset
银行存款占基金资产总值比 -> prt_cashtoasset
转融通证券出借业务市值占基金资产总值比 -> prt_seclendingvaluetoasset
买入返售证券占基金资产总值比例 -> mmf_reverserepotoasset
股票市值增长率 -> prt_stockvaluegrowth
债券市值增长率 -> prt_bondvaluegrowth
基金市值增长率 -> prt_fundvaluegrowth
权证市值增长率 -> prt_warrantvaluegrowth
银行存款市值增长率 -> prt_cashvaluegrowth
其他资产市值增长率 -> prt_othervaluegrowth
股票市值占基金资产净值比例增长 -> prt_stocktonavgrowth
债券市值占基金资产净值比例增长 -> prt_bondtonavgrowth
基金市值占基金资产净值比例增长 -> prt_fundtonavgrowth
权证市值占基金资产净值比例增长 -> prt_warranttonavgrowth
银行存款市值占基金资产净值比例增长 -> prt_cashtonavgrowth
其他资产市值占基金资产净值比例增长 -> prt_othertonavgrowth
基金杠杆率 -> prt_foundleverage
基金的杠杆倍数 -> fund_leveragemultiple
国家/地区投资市值占基金资产净值比例 -> prt_countryregioninvestmenttonav
国家/地区投资市值 -> prt_countryregioninvestment
国债市值 -> prt_governmentbond
同业存单市值 -> prt_CDs
央行票据市值 -> prt_centralbankbill
金融债市值 -> prt_financialbond
政策性金融债市值 -> prt_pfbvalue
企业发行债券市值 -> prt_corporatebond
企业债市值 -> prt_corporatebonds
短期融资券市值 -> prt_cpvalue
中期票据市值 -> prt_mtnvalue
可转债市值 -> prt_convertiblebond
资产支持证券市值 -> prt_absvalue
货币市场工具市值 -> prt_mmivalue
其他债券市值 -> prt_otherbond
分行业投资市值 -> prt_stockvalue_industry2
分行业投资市值(Wind全球行业) -> prt_gicsindustryvalue
分行业市值增长率 -> prt_stockvalue_industryvaluegrowth2
分行业市值占股票投资市值比 -> prt_stockvalue_industrytostock2
分行业市值占基金资产净值比 -> prt_stockvalue_industrytonav2
分行业投资市值占基金资产净值比例(Wind全球行业) -> prt_gicsindustryvaluetonav
分行业市值占基金资产总值比 -> prt_stockvalue_industrytoasset2
分行业市值占基金资产净值比增长 -> prt_stockvalue_industrytonavgrowth2

【13】量化因子
------------------------------
当日总股本_PIT -> dfa_tltshare
前5大股东持股比例之和_PIT -> holder_sumpcttop5
前5大股东持股比例平方之和_PIT -> holder_sumsqupcttop5
前10大股东持股比例平方之和_PIT -> holder_sumsqupcttop10
市盈率PE(TTM)_PIT -> pe_ttm
市盈率PE(TTM,扣除非经常性损益)PIT -> val_pe_deducted_ttm
市盈率PE/过去一个月PE的均值_PIT -> val_petohist20
市盈率PE/过去三个月PE的均值_PIT -> val_petohist60
市盈率PE/过去六个月PE的均值_PIT -> val_petohist120
市盈率PE/过去一年PE的均值_PIT -> val_petohist250
市盈率PE行业相对值_PIT -> val_peindu_sw
市净率PB行业相对值_PIT -> val_pbindu_sw
市销率PS(TTM)_PIT -> ps_ttm
市销率PS行业相对值_PIT -> val_psindu_sw
市现率PCF(经营现金流TTM)_PIT -> pcf_ocf_ttm
市现率PCF(现金净流量TTM)_PIT -> pcf_ncf_ttm
市现率PCF行业相对值_PIT -> val_pcfindu_sw
股息率（近12个月）_PIT -> dividendyield2
总市值/EBITDA(TTM反推法)_PIT -> val_mvtoebitda_ttm
总市值/息税折旧及摊销前利润TTM行业相对值_PIT -> val_pebitdaindu_sw_ttm
营业收入(TTM)/企业价值_PIT -> val_ortoev_ttm
资产总计/企业价值_PIT -> val_tatoev
对数市值_PIT -> val_Inmv
对数市值立方_PIT -> val_nlsize
自由流通市值_PIT -> val_floatmv
对数流通市值_PIT -> val_Infloatmv
对数总资产_PIT -> val_Intotassets
市值/企业自由现金流PIT -> val_mvtofcff
营收市值比(TTM)_PIT -> val_ortomv_ttm
账面市值比行业相对值_PIT -> val_btopindu_sw
所属申万一级行业的PE均值_PIT -> val_avgpe_sw
所属申万一级行业的PB均值_PIT -> val_avgpb_sw
所属申万一级行业的PS均值_PIT -> val_avgps_sw
所属申万一级行业的PCF均值_PIT -> val_avgpcf_sw
所属申万一级行业的账面市值比行业均值_PIT -> val_avgbtomv_sw
所属申万一级行业的总市值/息税折旧及摊销前利润TTM均值_. -> val_avgpebitda_sw
所属申万一级行业的PE标准差_PIT -> val_stdpe_sw
所属申万一级行业的PB标准差_PIT -> val_stdpb_sw
所属申万一级行业的PS标准差_PIT -> val_stdps_sw
所属申万一级行业的PCF标准差_PIT -> val_stdpcf_sw
所属申万一级行业的账面市值比行业标准差_PIT -> val_stdbtomv_sw
所属申万一级行业的总市值/息税折旧及摊销前利润TTM标准.. -> val_stdpebitda_sw
20日收益方差PIT -> risk_variance20
60日收益方差_PIT -> risk_variance60
120日收益方差PIT -> risk_variance120
20日正收益方差_PIT -> risk_gainvariance20
60日正收益方差_PIT -> risk_gainvariance60
120日正收益方差_PIT -> risk_gainvariance120
20日损失方差_PIT -> risk_lossvariance20
60日损失方差_PIT -> risk_lossvariance60
120日损失方差_PIT -> risk_lossvariance120
20日收益损失方差比PIT -> risk_glvarianceratio20
60日收益损失方差比_PIT -> risk_glvarianceRatio60
120日收益损失方差比PIT -> risk_glvarianceRatio120
个股20日的beta值_PIT -> risk_beta20
个股60日的beta值_PIT -> risk_beta60
个股120日的beta值_PIT -> risk_beta120
个股收益的20日峰度_PIT -> risk_kurtosis20
个股收益的60日峰度_PIT -> risk_kurtosis60
个股收益的120日峰度_PIT -> risk_kurtosis120
20日特诺雷比率_PIT -> risk_treynorratio20
60日特诺雷比率_PIT -> risk_treynorratio60
120日特诺雷比率_PIT -> risk_treynorratio120
12月累计收益_PIT -> risk_cumreturn12m
个股与市场波动率比值_PIT -> risk_volatilityratio
个股与市场相关系数_PIT -> risk_hisrelation
30日120日回报方差比率_PIT -> risk_revsvarratio
252日超额收益标准差_PIT -> risk_exstdev252
252日残差收益波动率_PIT -> risk_residvol252
一致预测净利润(FY1)变化率_1M_PIT -> west_netprofit_fy1_1m
一致预测净利润(FY1)变化率_3M_PIT -> west_netprofit_fy1_3m
一致预测净利润(FY1)变化率_6M_PIT -> west_netprofit_fy1_6m
一致预测净利润(FY1)的变化_1M_PIT -> west_netprofit_fy1_chg_1m
一致预测净利润(FY1)的变化_3M_PIT -> west_netprofit_fy1_chg_3m
一致预测净利润(FY1)的变化_6M_PIT -> west_netprofit_fy1_chg_6m
一致预测净利润(FY1)标准差_PIT -> west_stdnetprofit_fy1
一致预测净利润(FY1)最大与一致预测净利润(FY1)最小值的变.. -> west_netprofitmaxmin_fy1
一致预测净利润(NTM)的变化_1M_PIT -> west_netprofit_ftm_chg_1m
一致预测净利润(NTM)的变化_3M_PIT -> west_netprofit_ftm_chg_3m
一致预测净利润(NTM)的变化_6M_PIT -> west_netprofit_ftm_chg_6m
一致预测净利润(NTM)的变化率_1M_PIT -> west_netprofit_ftm_1m
一致预测净利润(NTM)的变化率_3M_PIT -> west_netprofit_ftm_3m
一致预测净利润(NTM)的变化率_6M_PIT -> west_netprofit_ftm_6m
一致预测净利润(NTM)与归属于母公司净利润(TTM)的差_PIT -> west_netprofitdiff
一致预测净利润(NTM)/归属于母公司的股东权益_PIT -> west_roe_ftm
一致预测每股收益(FY1)变化率_1M_PIT -> west_eps_fy1_1m
一致预测每股收益(FY1)变化率_3M_PIT -> west_eps_fy1_3m
一致预测每股收益(FY1)变化率_6M_PIT -> west_eps_fy1_6m
一致预测每股收益(FY1)的变化_1M_PIT -> west_eps_fy1_chg_1m
一致预测每股收益(FY1)的变化_3M_PIT -> west_eps_fy1_chg_3m
一致预测每股收益(FY1)的变化_6M_PIT -> west_eps_fy1_chg_6m
一致预测每股收益(FY1)标准差_PIT -> west_stdeps_fy1
一致预测每股收益(FY1)最大与一致预测每股收益(FY1)最小值.. -> west_epsmaxmin_fy1
一致预测每股收益(FY2)与一致预测每股收益(FY1)的变化率_PIT -> west_eps_fygrowth
一致预测每股收益(NTM)的变化_1M_PIT -> west_eps_ftm_chg_1m
一致预测每股收益(NTM)的变化_3M_PIT -> west_eps_ftm_chg_3m
一致预测每股收益(NTM)的变化_6M_PIT -> west_eps_ftm_chg_6m
一致预测每股收益(NTM)的变化率_1M_PIT -> west_eps_ftm_1m
一致预测每股收益(NTM)的变化率_3M_PIT -> west_eps_ftm_3m
一致预测每股收益(NTM)的变化率_6M_PIT -> west_eps_ftm_6m
一致预测每股收益(NTM)与EPS(TTM)的变化率_PIT -> west_eps_ftmgrowth
一致预测营业收入(FY1)变化率_1M_PIT -> west_sales_fy1_1m
一致预测营业收入(FY1)变化率_3M_PIT -> west_sales_fy1_3m
一致预测营业收入(FY1)变化率_6M_PIT -> west_sales_fy1_6m
一致预测营业收入(FY1)的变化_1M_PIT -> west_sales_fy1_chg_1m
一致预测营业收入(FY1)的变化_3M_PIT -> west_sales_fy1_chg_3m
一致预测营业收入(FY1)的变化_6M_PIT -> west_sales_fy1_chg_6m
一致预测营业收入(FY1)标准差_PIT -> west_stdsales_fy1
一致预测营业收入(FY1)最大与一致预测营业收入(FY1)最小值.. -> west_salesmaxmin_fy1
一致预测营业收入(NTM)的变化_1M_PIT -> west_sales_ftm_chg_1m
一致预测营业收入(NTM)的变化_3M_PIT -> west_sales_ftm_chg_3m
一致预测营业收入(NTM)的变化_6M_PIT -> west_sales_ftm_chg_6m
一致预测营业收入(NTM)的变化率_1M_PIT -> west_sales_ftm_1m
一致预测营业收入(NTM)的变化率_3M_PIT -> west_sales_ftm_3m
一致预测营业收入(NTM)的变化率_6M_PIT -> west_sales_ftm_6m
一致预测目标价上升空间_PIT -> west_freturn
基本每股收益_PIT -> fa_eps_basic
稀释每股收益_PIT -> fa_eps_diluted
每股净资产_PIT -> fa_bps
每股营业总收入_PIT -> fa_grps
每股营业收入_PIT -> fa_orps
每股营业利润_PIT -> fa_opps
每股资本公积_PIT -> fa_capsurpps
每股盈余公积_PIT -> fa_spps
每股未分配利润_PIT -> fa_undistributedps
每股留存收益_PIT -> fa_retainedps
每股企业自由现金流量_PIT -> fa_fcffps
每股股东自由现金流量_PIT -> fa_fcfeps
每股现金及现金等价物余额_PIT -> fa_cceps
股利保障倍数(TTM)_PIT -> fa_divcover_ttm
留存盈余比率(TTM)_PIT -> fa_retainedearn_ttm
每股现金流量净额(TTM)_PIT -> fa_cfps_ttm
每股经营活动产生的现金流量净额(TTM)_PIT -> fa_ocfps_ttm
每股营业利润(TTM)_PIT -> fa_opps_ttm
每股股利_PIT -> fa_dps
净资产收益率（平均）_PIT -> fa_roe_avg
净资产收益率（加权）_PIT -> fa_roe_wgt
净资产收益率（摊薄）_PIT -> fa_roe_diluted
净资产收益率（扣除/加权）PIT -> fa_roe_exbasic
净资产收益率（扣除/摊薄）_PIT -> fa_roe_exdiluted
净资产收益率(TTM)_PIT -> fa_roenp_ttm
总资产报酬率(TTM)_PIT -> fa_roaebit_ttm
总资产净利率-不含少数股东损益(TTM)_PIT -> fa_netprofittoassets_ttm
投入资本回报率(TTM)_PIT -> fa_roic_ttm
投入资本回报率ROIC(TTM)_PIT -> fa_roicebit_ttm
资本报酬率(TTM)_PIT -> fa_roc_ttm
资产回报率(TTM)_PIT -> fa_roa_ttm
5年收益增长率PIT -> fa_egro
5年营业收入增长率_PIT -> fa_sgro
5年平均资产回报率PIT -> fa_roaavg5y
权益回报率(TTM)PIT -> fa_roe_ttm
5年平均权益回报率_PIT -> fa_roeavg5y
成本费用利润率(TTM)_PIT -> fa_protocost_ttm
净利润/营业总收入(TTM)_PIT -> fa_profittogr_ttm
营业利润/营业收入(TTM)_PIT -> fa_optoor_ttm
营业利润/营业总收入(TTM)_PIT -> fa_optogr_ttm
息税前利润/营业总收入(TTM)_PIT -> fa_ebittogr_ttm
销售费用/营业总收入(TTM)_PIT -> fa_sellexpensetogr_ttm
管理费用/营业总收入(TTM)_PIT -> fa_adminexpensetogr_ttm
财务费用/营业总收入(TTM)_PIT -> fa_finaexpensetogr_ttm
资产减值损失/营业总收入(TTM)_PIT -> fa_impairtogr_ttm
营业总成本/营业总收入(TTM)_PIT -> fa_octogr_ttm
归属母公司股东的净利润/营业收入(TTM)_PIT -> fa_netprofittoor_ttm
税项/利润总额(TTM)_PIT -> fa_taxtoprofitbt_ttm
销售净利率(TTM)_PIT -> fa_netprofitmargin_ttm
销售毛利率(TTM)_PIT -> fa_grossprofitmargin_ttm
销售期间费用率(TTM)_PIT -> fa_expensetosales_ttm
销售成本率(TTM)_PIT -> fa_salestocost_ttm
销售税金率(TTM)_PIT -> fa_taxratio_ttm
现金流资产比-资产回报率(TTM)_PIT -> fa_acca_ttm
贝里比率(TTM)_PIT -> fa_berryratio_ttm
经营活动净收益/利润总额_PIT -> fa_operincometopbt
经营活动净收益/利润总额(TTM)_PIT -> fa_operincometopbt_ttm
价值变动净收益/利润总额(TTM)_PIT -> fa_chgvaluetopbt_ttm
营业外收支净额/利润总额(TTM)_PIT -> fa_nonoperprofittopbt_ttm
营业利润/利润总额(TTM)_PIT -> fa_optopbt_ttm
利润总额/营业收入(TTM)_PIT -> fa_pbttoor_ttm
收益市值比(TTM)_PIT -> fa_profittomv_ttm
5年平均收益市值比_PIT -> fa_pttomvavg5y
销售商品提供劳务收到的现金/营业收入_PIT -> fa_salescashtoor
销售商品提供劳务收到的现金/营业收入(TTM)_PIT -> fa_salescashtoor_ttm
经营活动产生的现金流量净额/营业收入_PIT -> fa_ocftoor
经营活动产生的现金流量净额/营业收入(TTM)_PIT -> fa_ocftoor_ttm
经营活动产生的现金流量净额/经营活动净收益(TTM)_PIT -> fa_ocftooai_ttm
经营活动产生的现金流量净额/营业利润(TTM)_PIT -> fa_ocftoop_ttm
现金股利保障倍数(TTM)_PIT -> fa_cashdivcover_ttm
现金流市值比_PIT -> fa_ctop
资金现金回收率(TTM)_PIT -> fa_cashrecovratio_ttm
非流动资产比率_PIT -> fa_noncurassetsratio
流动资产比率_PIT -> fa_curassetsratio
资产负债率_PIT -> fa_debttoasset
固定资产比率_PIT -> fa_fixedassettoasset
长期负债/资产总计_PIT -> fa_ltdebttoasset
长期借款/资产总计_PIT -> fa_ltborrowtoasset
股东权益比率_PIT -> fa_equityassetradio
股东权益/固定资产_PIT -> fa_equitytofixedasset
无形资产比率_PIT -> fa_intangassetratio
归属母公司股东的权益/带息债务_PIT -> fa_equitytointerestdebt
归属于母公司所有者权益合计/全部投入资本_PIT -> fa_equitytocapital
流动比率_PIT -> fa_current
速动比率_PIT -> fa_quick
超速动比率_PIT -> fa_superquick
有形净值/带息债务_PIT -> fa_tangibleatointerestdebt
有形净值/净债务_PIT -> fa_tangibleassettonetdebt
有形净值债务率_PIT -> fa_debttotangibleafybl
经营活动产生的现金流量净额/负债合计_PIT -> fa_ocftodebt
经营活动产生现金流量净额/带息债务(TTM)_PIT -> fa_ocftointerestdebt_ttm
经营活动产生现金流量净额/净债务(TTM)_PIT -> fa_ocftonetdebt_ttm
带息债务/全部投入资本_PIT -> fa_interestdebttocapital
产权比率_PIT -> fa_debttoequity
利息保障倍数_PIT -> fa_ebittointerest
长期负债/营运资金_PIT -> fa_uncurdebttoworkcap
账面杠杆_PIT -> fa_blev
债务总资产比_PIT -> fa_debtsassetratio
现金流动负债比(TTM)_PIT -> fa_cfotocurliabs_ttm
现金流动负债比率_PIT -> fa_cashtocurliabs
市场杠杆_PIT -> fa_mlev
应付债券/资产总计_PIT -> fa_bondspayabletoasset
应收账款周转率(TTM)_PIT -> fa_arturn_ttm
应付账款周转率(TTM)_PIT -> fa_apturn_ttm
固定资产周转率(TTM)_PIT -> fa_faturn_ttm
总资产周转率(TTM)_PIT -> fa_taturn_ttm
营业周期(TTM)_PIT -> fa_turndays_ttm
存货周转天数(TTM)_PIT -> fa_invturndays_ttm
应收账款周转天数(TTM)_PIT -> fa_arturndays_ttm
应付账款周转天数(TTM)_PIT -> fa_apturndays_ttm
存货周转率(TTM)_PIT -> fa_invturn_ttm
现金转换周期(TTM)_PIT -> fa_cashcnvcycle_ttm
流动资产周转率(TTM)_PIT -> fa_currtassetstrate_ttm
净资产周转率(TTM)_PIT -> fa_naturn_ttm
增长率-营业收入(TTM)_PIT -> fa_orgr_ttm
增长率-净现金流量(TTM)_PIT -> fa_ncgr_ttm
增长率-利润总额(TTM)_PIT -> fa_tpgr_ttm
增长率-营业利润(TTM)_PIT -> fa_oigr_ttm
增长率-净利润(TTM)_PIT -> fa_npgr_ttm
增长率-归属母公司股东的净利润(TTM)_PIT -> fa_nppcgr_ttm
增长率-经营活动产生的现金流量净额(TTM)_PIT -> fa_cfogr_ttm
增长率-筹资活动产生的现金流量净额(TTM)_PIT -> fa_cffgr_ttm
增长率-投资活动产生的现金流量净额(TTM)_PIT -> fa_cfigr_ttm
增长率-毛利率(TTM)_PIT -> fa_gpmgr_ttm
增长率-总资产_PIT -> fa_tagr
增长率-净资产_PIT -> fa_nagr
八季度净利润变化趋势_PIT -> fa_earnmom8qtr
企业自由现金流量PIT -> fa_fcff
股权自由现金流量_PIT -> fa_fcfe
非经常性损益PIT -> fa_nrgl
经营活动净收益_PIT -> fa_oaincome
运营资本_PIT -> fa_workcapital
有形资产_PIT -> fa_tangibleasset
留存收益PIT -> fa_retainearn
带息债务_PIT -> fa_interestdebt
净债务_PIT -> fa_netdebt
无息流动负债_PIT -> fa_nicurdebt
无息非流动负债_PIT -> fa_ninocurdebt
息前税后利润_PIT -> fa_ebiat
折旧和摊销_PIT -> fa_da
归属于母公司的股东权益_PIT -> fa_equity
全部投入资本_PIT -> fa_investcapital
资产总计_PIT -> fa_totassets
固定资产合计_PIT -> fa_fixassets
负债合计_PIT -> fa_totliab
股东权益_PIT -> fa_totequity
期末现金及现金等价物_PIT -> fa_cce
营业总收入(TTM)_PIT -> fa_gr_ttm
营业总成本(TTM)_PIT -> fa_gc_ttm
营业收入(TTM)_PIT -> fa_or_ttm
营业成本-非金融类(TTM)_PIT -> fa_ocnf_ttm
营业支出-金融类(TTM)_PIT -> fa_oef_ttm
毛利(TTM)_PIT -> fa_gp_ttm
销售费用(TTM)_PIT -> fa_sellexpense_ttm
管理费用(TTM)_PIT -> fa_adminexpense_ttm
财务费用(TTM)_PIT -> fa_finaexpense_ttm
期间费用(TTM)_PIT -> fa_perexpense_ttm
利息支出(TTM)_PIT -> fa_interestexpense_ttm
少数股东损益(TTM)_PIT -> fa_mininterest_ttm
资产减值损失(TTM)_PIT -> fa_impairloss_ttm
经营活动净收益(TTM)_PIT -> fa_operactincome_ttm
价值变动净收益(TTM)_PIT -> fa_chavalincome_ttm
营业利润(TTM)_PIT -> fa_op_ttm
营业外收支净额(TTM)_PIT -> fa_nooperprofit_ttm
息税前利润(TTM反推法)_PIT -> fa_ebitunver_ttm
所得税(TTM)_PIT -> fa_tax_ttm
利润总额(TTM)_PIT -> fa_ebt_ttm
净利润(TTM)_PIT -> fa_profit_ttm
归属母公司股东的净利润(TTM)_PIT -> fa_netprofit_ttm
扣除非经常性损益后的净利润(TTM)_PIT -> fa_deductprofit_ttm
EBITDA(TTM反推法)_PIT -> fa_ebitdainver_ttm
销售商品提供劳务收到的现金(TTM)_PIT -> fa_salescash_ttm
经营活动现金净流量(TTM)_PIT -> fa_operactcashflow_ttm
投资活动现金净流量(TTM)_PIT -> fa_inveactcashflow_ttm
筹资活动现金净流量(TTM)_PIT -> fa_finaactcashflow_ttm
现金净流量(TTM)_PIT -> fa_cashflow_ttm
营业税金及附加(TTM)_PIT -> fa_opertax_ttm

【14】其他
------------------------------
过去5日的价格动量_PIT -> tech_revs5
过去10日的价格动量_PIT -> tech_revs10
过去20日的价格动量_PIT -> tech_revs20
过去3个月的价格动量_PIT -> tech_revs60
过去6个月的价格动量_PIT -> tech_revs120
过去1年的价格动量_PIT -> tech_revs250
过去3年的价格动量_PIT -> tech_revs750
过去5日的价格动量-过去1个月的价格动量_PIT -> tech_revs5m20
过去5日的价格动量-过去3个月的价格动量_PIT -> tech_revs5m60
过去6个月的动量-过去1个月的动量_PIT -> tech_revs6m20
过去12个月的动量-过去1个月的动量_PIT -> tech_revs12m20
过去5日收益率/行业均值_PIT -> tech_revs5indu1
过去1个月收益率/行业均值_PIT -> tech_revs20indu1
过去1个月的日收益率的最大值_PIT -> tech_revs1mmax
当前股价/过去1个月股价均值-1_PIT -> tech_price1m
当前股价/过去3个月股价均值-1_PIT -> tech_price3m
当前股价/过去1年的股价均值-1_PIT -> tech_price1y
6日变动速率_PIT -> tech_roc6
20日变动速率_PIT -> tech_roc20
下轨线（布林线）_PIT -> tech_bolldown
上轨线（布林线）_PIT -> tech_bollup
12M收益率的120D变化率_PIT -> tech_revs12m6m
1-过去一个月收益率排名/股票总数的比值_PIT -> tech_rank1m
LN(最近一个月最高价/最近一个月最低价)_PIT -> tech_Inhighlow20d
当前交易量/过去1个月日均交易量*过去一个月的收益率_PIT -> tech_volumn1m
5日乖离率PIT -> tech_bias5
10日乖离率PIT -> tech_bias10
20日乖离率_PIT -> tech_bias20
60日乖离率_PIT -> tech_bias60
异同离差乖离率_PIT -> tech_dbcd
5日顺势指标_PIT -> tech_cci5
10日顺势指标_PIT -> tech_cci10
20日顺势指标_PIT -> tech_cci20
88日顺势指标_PIT -> tech_cci88
收益相对金额比_PIT -> tech_illiquidity
股价偏度_PIT -> tech_skewness
换手率相对波动率PIT -> tech_turnoverratevolatility20
相对离散指数_PIT -> tech_rvi
下跌相关系数_PIT -> tech_ddncr
下跌波动_PIT -> tech_ddnsr
钱德动量摆动指标PIT -> tech_cmo
CMO的中间因子SD_PIT -> tech_chandesd
CMO的中间因子SU_PIT -> tech_chandesu
相对强弱指标_PIT -> tech_rsi
动态买卖气指标_PIT -> tech_adtm
ADTM的中间因子SBM_PIT -> tech_sbm
ADTM的中间因子STM_PIT -> tech_stm
随机指标KDJK_PIT -> tech_kdj_k
随机指标KDJ_D_PIT -> tech_kdj_d
随机指标KDJJ_PIT -> tech_kdj_j
多空指数_PIT -> tech_bbi
BBI除以收盘价_PIT -> tech_bbic
5日平均换手率_PIT -> tech_turnoverrate5
10日平均换手率_PIT -> tech_turnoverrate10
20日平均换手率_PIT -> tech_turnoverrate20
60日平均换手率_PIT -> tech_turnoverrate60
120日平均换手率_PIT -> tech_turnoverrate120
240日平均换手率_PIT -> tech_turnoverrate240
3个月换手率对数平均_PIT -> tech_stoq
12个月换手率对数平均_PIT -> tech_stoa
5日平均换手率/120日平均换手率_PIT -> tech_turn5dturn120
10日平均换手率/120日平均换手率_PIT -> tech_turn10dturn120
20日平均换手率/120日平均换手率_PIT -> tech_turn20dturn120
6日成交金额的移动平均值_PIT -> tech_tvma6
20日成交金额的移动平均值_PIT -> tech_tvma20
6日成交金额的标准差_PIT -> tech_tvstd6
20日成交金额的标准差_PIT -> tech_tvstd20
成交量的5日指数移动平均_PIT -> tech_vema5
成交量的10日指数移动平均_PIT -> tech_vema10
成交量的12日指数移动平均_PIT -> tech_vema12
成交量的26日指数移动平均_PIT -> tech_vema26
能量潮指标_PIT -> tech_obv
6日能量潮指标_PIT -> tech_obv6
20日能量潮指标_PIT -> tech_obv20
成交量量指数平滑异同移动平均线_PIT -> tech_vmacd
VMACD的中间变量VDEA_PIT -> tech_vdea
VMACD的中间变量VDIFF_PIT -> tech_vdiff
6日量变动速率指标_PIT -> tech_vroc6
12日量变动速率指标_PIT -> tech_vroc12
过去1个月交易量/过去3个月的平均交易量_PIT -> tech_volume1m60
交易量波动率_PIT -> tech_volumevolatility
成交额惯性_PIT -> tech_amount1m60
成交量比率_PIT -> tech_vr
成交量震荡_PIT -> tech_vosc
10日成交量标准差_PIT -> tech_vstd10
20日成交量标准差_PIT -> tech_vstd20
20日资金流量_PIT -> tech_moneyflow20
资金流量指标PIT -> tech_mfi
威廉变异离散量(WVAD)6日均值_PIT -> tech_mawvad
市场促进指数指标PIT -> tech_mktfaciind
12月相对强势_PIT -> tech_rstr12
24月相对强势_PIT -> tech_rstr24
ARBR人气意愿指标_PIT -> tech_arbr
AR人气指标_PIT -> tech_ar
BR意愿指标_PIT -> tech_br
CR能量指标_PIT -> tech_cr20
多头力道_PIT -> tech_bullpower
空头力道PIT -> tech_bearpower
市场能量指标PIT -> tech_cyf
心理线指标_PIT -> tech_psy
12日变化率指数_PIT -> tech_RC12
24日变化率指数_PIT -> tech_RC24
梅斯线_PIT -> tech_mass
艾达透视指标PIT -> tech_elder
正成交量指标_PIT -> tech_pvi
负成交量指标_PIT -> tech_nvi
累积/派发线_PIT -> tech_ad
6日收集派发指标_PIT -> tech_ad6
20日收集派发指标PIT -> tech_ad20
6日简易波动指标_PIT -> tech_emv6
14日简易波动指标_PIT -> tech_emv14
6日均幅指标_PIT -> tech_ATR6
14日均幅指标_PIT -> tech_ATR14
5日移动均线_PIT -> tech_MA5
10日移动均线_PIT -> tech_MA10
20日移动均线_PIT -> tech_MA20
60日移动均线_PIT -> tech_MA60
120日移动均线_PIT -> tech_MA120
5日指数移动均线_PIT -> tech_EMA5
10日指数移动均线_PIT -> tech_EMA10
12日指数移动均线_PIT -> tech_EMA12
30日指数移动均线_PIT -> tech_EMA20
16日指数移动均线_PIT -> tech_EMA26
10日指数移动均线_PIT -> tech_EMA60
720日指数移动均线_PIT -> tech_EMA120
平滑异同移动平均线_PIT -> tech_macd
MACD的中间因子DEA_PIT -> tech_dea
MACD的中间因子DIFF_PIT -> tech_diff
佳庆指标PIT -> tech_chaikin
佳庆离散指标_PIT -> tech_chaikinvol
方向标准离差指数_PIT -> tech_DDI
DDI的中间因子DIZ_PIT -> tech_DIZ
DDI的中间因子DIF_PIT -> tech_DIF
5日收盘价三重指数平滑移动平均指标_PIT -> tech_trix5
10日收盘价三重指数平滑移动平均指标_PIT -> tech_trix10
5日三重指数移动平均线_PIT -> tech_tema5
10日三重指数移动平均线_PIT -> tech_tema10
均线价格比_PIT -> tech_ma10close
阶段强势指标_PIT -> tech_jdqs20
绝对偏差移动平均PIT -> tech_apbma
阿隆指标_PIT -> tech_aroon
阿隆向上指标_PIT -> tech_aroonup
阿隆向下指标_PIT -> tech_aroondown
波幅中位数_PIT -> tech_dhilo
估波指标PIT -> tech_coppockcurve
累计振动升降指标_PIT -> tech_asi
与过去1个月、3个月、6个月、12个月股价平均涨幅_PIT -> tech_chg_avg
与过去52周股价最高点差距_PIT -> tech_chgmax
终极指标_PIT -> tech_uos
加权市净率_PIT -> val_pb_wgt
算术平均滚动市盈率_PIT -> val_pe_avg
上涨的股票占指数成份股的比例_PIT -> tech_uppct
下跌的股票占指数成份股的比例_PIT -> tech_downpct
涨停的股票占指数成份股的比例_PIT -> tech_limituppct
跌停的股票占指数成份股的比例_PIT -> tech_limitdownpct

